left_image_ID,right_image_ID,study_question,left_num,right_num,total
513e5dc3fdc9f0358700aeab,5140d960fdc9f04926003bb4,livelier,7,9,16
50f448abfdc9f065f0004161,513d699ffdc9f035870047c4,safer,0,69,69
50f42c43fdc9f065f000198c,5185d4edfdc9f03fd5001448,safer,41,24,65
50f5e56cfdc9f065f00068d7,513d5c71fdc9f03587003704,safer,43,3,46
513e5d95fdc9f0358700ae31,51422ad6fdc9f049260089a5,more depressing,0,45,45
51409ce6fdc9f04926001250,514139f7fdc9f049260055be,wealthier,29,16,45
513f2d0cfdc9f0358700d985,51414cbbfdc9f049260073e1,safer,0,42,42
513cc2aafdc9f035870015bf,513e6f56fdc9f0358700c565,livelier,39,0,39
513e2197fdc9f0358700a46a,513e6087fdc9f0358700b3e9,more depressing,0,39,39
513f2e7dfdc9f0358700dc0a,51422896fdc9f0492600878f,safer,34,4,38
50f5e8aafdc9f065f000748e,513f1205fdc9f0358700c8f5,livelier,8,29,37
513d9c2efdc9f03587007c5a,5185d3ddfdc9f03fd5001341,safer,0,37,37
513d51c4fdc9f03587002ed6,5141353efdc9f04926004941,more depressing,1,33,34
513d5d5dfdc9f035870038a1,513d6a3ffdc9f035870049e5,more depressing,34,0,34
513d37b2fdc9f03587002c11,513e657ffdc9f0358700b991,safer,32,0,32
50f46485fdc9f065f00046be,5140c825fdc9f04926002149,more depressing,29,3,32
513cc0e8fdc9f03587001411,51414e2dfdc9f0492600779a,safer,30,1,31
513d7888fdc9f035870061cb,5185d41afdc9f03fd500137c,more depressing,8,22,30
50f42b4ffdc9f065f00012b6,50f43aadfdc9f065f0002ef0,safer,0,28,28
513d69c5fdc9f03587004849,513e1d68fdc9f035870099c2,more beautiful,0,27,27
513d3230fdc9f03587002883,513e212dfdc9f0358700a3e1,safer,27,0,27
51409944fdc9f04926000dc5,51421ad0fdc9f049260083ae,safer,26,1,27
513d592cfdc9f0358700336d,513d7e48fdc9f0358700738f,safer,2,25,27
50f433c6fdc9f065f000268a,5185cffffdc9f03fd5000fb1,livelier,26,0,26
513e1ca9fdc9f035870097cc,51408bedfdc9f0358700ea17,more depressing,19,7,26
50f42c55fdc9f065f0001b66,513e5beefdc9f0358700a9a6,more boring,23,2,25
50f43537fdc9f065f0002d02,51422955fdc9f0492600883f,more beautiful,0,24,24
50f43527fdc9f065f0002bcb,513e20b9fdc9f0358700a29a,livelier,3,21,24
513e6d72fdc9f0358700c2c8,51409049fdc9f04926000276,livelier,24,0,24
51413591fdc9f04926004a5d,51414593fdc9f04926006617,more beautiful,0,23,23
513f3232fdc9f0358700e050,51421a65fdc9f04926008335,safer,2,21,23
50f43aa6fdc9f065f0002e73,50f61679beb2fed9100008e9,livelier,23,0,23
50f43532fdc9f065f0002ca6,513d9b96fdc9f03587007a6a,safer,2,21,23
513d7ba5fdc9f03587006c27,513e20fafdc9f0358700a34a,more beautiful,1,21,22
5140953cfdc9f0492600095a,5141480efdc9f04926006bd2,safer,18,4,22
50f44807fdc9f065f0003ca9,50f55e52fdc9f065f0004bcb,livelier,0,22,22
50f5ee94fdc9f065f0008eb3,513f2c49fdc9f0358700d843,safer,0,22,22
50f42eb3fdc9f065f00023c7,513d6b8efdc9f03587004d50,safer,0,22,22
513d59a9fdc9f035870033a8,513d7d5efdc9f035870071a6,more depressing,19,2,21
50f433d9fdc9f065f00027b8,51415199fdc9f04926007fc4,safer,21,0,21
50f5e8a5fdc9f065f000742d,513e1c4cfdc9f035870096d6,wealthier,3,18,21
513cca02fdc9f03587001ca9,514135fdfdc9f04926004bb5,safer,2,19,21
513cda9efdc9f0358700201c,5140cb89fdc9f04926002baf,livelier,16,5,21
513e22e5fdc9f0358700a5f2,51413c72fdc9f04926005b26,more boring,0,21,21
513d7f4afdc9f035870075a6,5185ce50fdc9f03fd5000e08,safer,1,20,21
513cc1befdc9f035870014dc,513d9fa9fdc9f035870087ba,safer,1,19,20
50f6166fbeb2fed91000084e,513d7f35fdc9f03587007583,safer,20,0,20
513cd58cfdc9f03587001f0e,51414c79fdc9f04926007340,more beautiful,20,0,20
50f43494fdc9f065f00029d6,50f5ed68fdc9f065f0008d1b,wealthier,20,0,20
513e1aeafdc9f03587009322,5140d80cfdc9f0492600392e,more depressing,2,18,20
50f42b82fdc9f065f0001468,513e6facfdc9f0358700c5e0,safer,0,20,20
50f439fbfdc9f065f0002e52,513d57e4fdc9f03587003240,wealthier,0,19,19
513e5d1dfdc9f0358700ace0,513f2c54fdc9f0358700d85a,safer,0,19,19
513d9c9cfdc9f03587007dd0,5140cc11fdc9f04926002cec,safer,0,19,19
50f5eaf0fdc9f065f0007e74,514098ebfdc9f04926000d45,more boring,0,19,19
513d6c1bfdc9f03587004eaf,51408ffafdc9f049260001d5,safer,19,0,19
513d9ae9fdc9f03587007847,51413a8afdc9f0492600572d,livelier,18,0,18
513e1f3cfdc9f03587009e91,51414de0fdc9f049260076e1,livelier,0,18,18
50f5ec9cfdc9f065f0008a7d,5185cbc1fdc9f03fd5000b83,wealthier,18,0,18
513e5e55fdc9f0358700b035,5141369efdc9f04926004c9a,safer,0,18,18
50e5faefd7c3df413b000787,513d31f8fdc9f03587002855,wealthier,0,18,18
513d5b22fdc9f035870034ac,51409a17fdc9f04926000ed2,safer,11,7,18
513cb9f8fdc9f03587000d77,513e6fddfdc9f0358700c61e,safer,11,7,18
50f55e18fdc9f065f0004a76,513d7ebffdc9f03587007483,more beautiful,16,2,18
50f56198fdc9f065f000559d,50f561c4fdc9f065f00056bd,more depressing,17,1,18
50f43490fdc9f065f0002999,50f46497fdc9f065f00047ef,safer,1,17,18
513cc348fdc9f03587001659,5140c889fdc9f0492600227a,more beautiful,17,0,17
50f447cffdc9f065f0003a39,513d5795fdc9f035870031b0,livelier,3,14,17
513d5c0dfdc9f03587003652,513e2155fdc9f0358700a41e,wealthier,10,7,17
513cbd5afdc9f03587001095,513e2298fdc9f0358700a58d,livelier,16,1,17
50f3981ffdc9f065f0000dfa,514146dffdc9f04926006902,safer,15,2,17
513d317cfdc9f035870027f6,513d3442fdc9f03587002a00,safer,0,17,17
513d7beffdc9f03587006d1b,5140ccbffdc9f04926002e88,safer,16,1,17
513d5eb2fdc9f03587003ad0,513f28ebfdc9f0358700d294,safer,0,17,17
50f44567fdc9f065f00034df,5185cf8afdc9f03fd5000f44,wealthier,17,0,17
50f5eb44fdc9f065f0008157,513f2b5afdc9f0358700d6b1,safer,17,0,17
50f5eaecfdc9f065f0007e2c,513cc07efdc9f035870013a4,safer,16,1,17
513e1bcbfdc9f03587009579,513f123efdc9f0358700c93f,more beautiful,17,0,17
513d9fadfdc9f035870087c3,513e6b8ffdc9f0358700c04c,more boring,1,15,16
50f5eb70fdc9f065f0008353,513d2caefdc9f03587002450,more depressing,0,16,16
5140cfa7fdc9f0492600316e,51413b3afdc9f049260058e8,more boring,16,0,16
513da078fdc9f0358700899f,5140ce16fdc9f04926002ff9,livelier,0,16,16
50f563b6fdc9f065f0005df8,5185d409fdc9f03fd5001369,more boring,0,16,16
50f42c7efdc9f065f0001d60,51408f51fdc9f04926000088,more beautiful,3,13,16
5140d00bfdc9f049260031d5,51413aeefdc9f04926005829,more boring,15,1,16
51409d64fdc9f049260012e8,51413678fdc9f04926004c61,livelier,1,15,16
513d5337fdc9f03587002f01,51409850fdc9f04926000c7b,more boring,16,0,16
51414893fdc9f04926006d05,51422a17fdc9f049260088e0,safer,9,7,16
513cee1dfdc9f035870023ec,513d9e41fdc9f03587008359,safer,14,2,16
513d6a82fdc9f03587004aa8,513e1d58fdc9f03587009995,more beautiful,0,16,16
513cbe26fdc9f03587001156,5140da01fdc9f04926003d14,wealthier,10,6,16
50f46442fdc9f065f000446b,513ce751fdc9f0358700229d,safer,16,0,16
50f5ec9bfdc9f065f0008a64,513cdfa1fdc9f03587002133,livelier,16,0,16
50f55e56fdc9f065f0004c19,50f55eaefdc9f065f0004de4,safer,15,1,16
50f6167abeb2fed910000905,513da0a7fdc9f035870089fd,safer,13,3,16
513e6bfdfdc9f0358700c0d8,5140cca7fdc9f04926002e5a,safer,1,15,16
50f42c4cfdc9f065f0001a65,513cca18fdc9f03587001cb8,safer,15,1,16
50f5eab0fdc9f065f0007c43,50f5ecf1fdc9f065f0008b44,wealthier,15,1,16
513e1a7efdc9f03587009212,513e5fbbfdc9f0358700b2af,more depressing,3,13,16
50f607dcbeb2fed6f800033d,51422ccbfdc9f04926008b81,safer,5,11,16
50f448b5fdc9f065f0004234,5140cbbcfdc9f04926002c37,livelier,0,16,16
50f448b5fdc9f065f0004224,51409989fdc9f04926000e1d,more boring,15,1,16
513cbbd8fdc9f03587000f32,514218befdc9f04926008184,wealthier,2,13,15
513d6b8ffdc9f03587004d51,51414f0bfdc9f049260079c6,safer,14,1,15
50f46483fdc9f065f0004698,50f60871beb2fed6f80004c7,livelier,14,1,15
513d6caefdc9f0358700501d,51409050fdc9f04926000285,safer,15,0,15
50f5ee96fdc9f065f0008edd,513f2c9bfdc9f0358700d8ce,safer,0,15,15
513e1a80fdc9f03587009218,514144b0fdc9f0492600651f,safer,15,0,15
513d9deefdc9f0358700823b,513e5d16fdc9f0358700accf,safer,15,0,15
50f5644ffdc9f065f0006280,51421958fdc9f04926008222,more beautiful,11,4,15
513e216afdc9f0358700a435,513f2a8bfdc9f0358700d55c,more depressing,0,15,15
513cdd7efdc9f035870020bd,513d681bfdc9f03587004261,safer,4,11,15
5141498dfdc9f04926006dfe,5185c375fdc9f03fd5000a8f,safer,15,0,15
50f43ba7fdc9f065f00032b6,5185cb34fdc9f03fd5000af8,more beautiful,0,15,15
51422dc3fdc9f04926008c72,5185d433fdc9f03fd500139a,safer,4,11,15
513e2266fdc9f0358700a554,51413520fdc9f049260048da,livelier,7,8,15
513d7f27fdc9f03587007564,51413550fdc9f04926004980,wealthier,12,3,15
50f5eaedfdc9f065f0007e46,513e5d1efdc9f0358700ace4,wealthier,2,13,15
50f42c0cfdc9f065f0001798,50f5ec32fdc9f065f00087ab,wealthier,15,0,15
513cc7c6fdc9f03587001a98,513d3631fdc9f03587002b70,wealthier,12,2,14
50f43464fdc9f065f00027eb,513d9b45fdc9f03587007972,safer,14,0,14
50f5e8cdfdc9f065f0007518,514146d0fdc9f049260068dc,safer,13,1,14
50f56412fdc9f065f00060b3,513d6a45fdc9f035870049fa,more depressing,0,14,14
50f42efefdc9f065f0002537,514139c6fdc9f0492600554c,livelier,4,10,14
513ce8b1fdc9f035870022e6,514099c7fdc9f04926000e6a,wealthier,1,13,14
513d36cefdc9f03587002bbf,513e1cf5fdc9f03587009893,livelier,1,13,14
513cd80cfdc9f03587001f98,513e5feefdc9f0358700b2f9,safer,5,9,14
50f56364fdc9f065f0005d4c,51414b69fdc9f0492600709e,safer,1,13,14
50f5e70afdc9f065f0006ff6,5141514afdc9f04926007f59,wealthier,0,14,14
513cc1e6fdc9f035870014ff,5140b8dcfdc9f04926001d2a,more boring,13,1,14
50f43b77fdc9f065f0003162,513d9d37fdc9f03587007fc8,livelier,14,0,14
5140ca1ffdc9f0492600273e,5140cd9ffdc9f04926002f86,livelier,14,0,14
50f448b1fdc9f065f00041e1,513d6930fdc9f03587004641,livelier,14,0,14
513f2c81fdc9f0358700d8a6,514151aafdc9f04926007fdb,more boring,0,14,14
50f60870beb2fed6f80004a9,514139dafdc9f04926005574,more boring,0,14,14
513d5731fdc9f0358700310c,513f13fafdc9f0358700cba4,livelier,14,0,14
50f46497fdc9f065f00047df,513d68effdc9f03587004551,livelier,14,0,14
50f55e1dfdc9f065f0004aee,5140b6adfdc9f049260017b7,more boring,14,0,14
50f5e760fdc9f065f00070c7,513d5c39fdc9f0358700369a,livelier,2,12,14
50f5eaa4fdc9f065f0007b75,513f116efdc9f0358700c82d,safer,0,14,14
50f5e760fdc9f065f00070d1,51414722fdc9f049260069ac,livelier,14,0,14
50f5eb6dfdc9f065f000830e,5140db8ffdc9f04926003f01,safer,13,1,14
50f5642ffdc9f065f0006153,51413972fdc9f04926005487,more depressing,6,7,13
50f5e647fdc9f065f0006bee,51408ae1fdc9f0358700e7ff,safer,1,12,13
513ce063fdc9f03587002157,514089a8fdc9f0358700e570,safer,4,9,13
513d9a93fdc9f0358700771a,513f2bc3fdc9f0358700d761,safer,12,1,13
513d7f41fdc9f03587007599,513e1f2ffdc9f03587009e68,livelier,1,12,13
50f5611cfdc9f065f00053fd,50f5ecf0fdc9f065f0008b33,livelier,13,0,13
50f445acfdc9f065f0003583,51409873fdc9f04926000cad,livelier,12,1,13
50f42bb5fdc9f065f0001657,513e6e88fdc9f0358700c450,livelier,0,13,13
51408971fdc9f0358700e4fe,5140ca28fdc9f0492600275d,more depressing,0,13,13
513d6876fdc9f0358700439f,513d7c3bfdc9f03587006e17,livelier,5,8,13
51413d78fdc9f04926005d4a,5185cbf8fdc9f03fd5000bb9,livelier,12,1,13
513cb5c2fdc9f03587000989,5185cc8ffdc9f03fd5000c49,wealthier,3,10,13
50f5ec40fdc9f065f00088b0,514147abfdc9f04926006ae4,more boring,2,11,13
513cb828fdc9f03587000bc3,51413ff1fdc9f0492600603d,livelier,0,13,13
513d7940fdc9f0358700643e,5140d77dfdc9f04926003808,safer,10,3,13
513d6bcefdc9f03587004dea,513e60f2fdc9f0358700b498,livelier,0,13,13
50f46498fdc9f065f000482b,51413a73fdc9f049260056f4,more beautiful,11,2,13
50f463cafdc9f065f00043cc,51421c0bfdc9f049260084fe,safer,1,12,13
513cc714fdc9f035870019f0,513e6e82fdc9f0358700c447,livelier,0,13,13
513cd556fdc9f03587001f01,51413442fdc9f049260045b6,more beautiful,11,2,13
513e1f0efdc9f03587009e1b,514091c5fdc9f04926000598,safer,8,5,13
50f42c80fdc9f065f0001de0,513e6ffcfdc9f0358700c64d,safer,12,1,13
50f5eaeffdc9f065f0007e62,513cbfdafdc9f03587001306,more boring,13,0,13
513e20f0fdc9f0358700a332,513e227cfdc9f0358700a56e,livelier,1,12,13
50f5eb29fdc9f065f000809a,513d9dbdfdc9f0358700819f,more boring,13,0,13
50f5625ffdc9f065f00059ad,514137d6fdc9f0492600508d,livelier,0,13,13
50f5612efdc9f065f000550b,513f2f0ffdc9f0358700dd00,safer,12,1,13
513cc6b4fdc9f03587001995,513ce6a7fdc9f0358700227c,safer,12,0,12
513d6872fdc9f0358700438e,5185d51afdc9f03fd5001479,livelier,8,4,12
513e61fafdc9f0358700b61d,51415059fdc9f04926007d0f,safer,0,12,12
50f60b91beb2fed910000088,513e1d50fdc9f03587009982,safer,12,0,12
50f44868fdc9f065f0004035,513f12a6fdc9f0358700c9dc,wealthier,10,2,12
50f61676beb2fed9100008c7,5141330cfdc9f04926004183,livelier,12,0,12
5141360ffdc9f04926004bd3,51422a0afdc9f049260088d1,livelier,2,10,12
5141335cfdc9f04926004296,5141480afdc9f04926006bcc,safer,12,0,12
513e22fbfdc9f0358700a60c,51408f4ffdc9f04926000081,safer,12,0,12
5140b952fdc9f04926001e14,514217c9fdc9f04926008080,livelier,0,12,12
51409a85fdc9f04926000f65,514139acfdc9f0492600550c,livelier,12,0,12
513e1b70fdc9f03587009495,513e22a4fdc9f0358700a5a1,safer,11,1,12
51409b57fdc9f0492600106d,51413520fdc9f049260048db,more depressing,0,12,12
513d3072fdc9f03587002725,5140ca75fdc9f04926002844,livelier,12,0,12
50f5e63afdc9f065f0006b4e,5140cbf7fdc9f04926002cb4,livelier,12,0,12
50f4348dfdc9f065f0002957,513e5d50fdc9f0358700ad6a,safer,1,11,12
513cc274fdc9f0358700158c,513e2086fdc9f0358700a21c,livelier,0,12,12
513d788efdc9f035870061dc,51414cf0fdc9f04926007467,livelier,0,12,12
50f5e6fcfdc9f065f0006e7d,513d6b6cfdc9f03587004cfa,more depressing,12,0,12
50f55e08fdc9f065f0004a00,5140d9b1fdc9f04926003c68,more beautiful,9,3,12
50f5eb6cfdc9f065f00082f9,5140d292fdc9f049260032fc,more depressing,12,0,12
513d7ac4fdc9f03587006941,514139c2fdc9f04926005544,more depressing,1,11,12
513e1b25fdc9f035870093be,5140c8ebfdc9f049260023a6,wealthier,0,12,12
513e20adfdc9f0358700a27c,513e2180fdc9f0358700a44d,safer,0,12,12
513d7c5efdc9f03587006e88,51413a6bfdc9f049260056dc,livelier,0,12,12
513f135bfdc9f0358700cacb,513f2ae8fdc9f0358700d5f4,livelier,8,3,11
50f44563fdc9f065f000349e,50f60121beb2fed6f80001b9,livelier,0,11,11
513f30d1fdc9f0358700df26,5140cb8ffdc9f04926002bc0,more depressing,8,3,11
50f43b6dfdc9f065f0003088,50f447d3fdc9f065f0003aa5,safer,4,7,11
513cef4dfdc9f03587002428,5140cf62fdc9f04926003133,safer,11,0,11
513d5ca8fdc9f03587003764,514138d3fdc9f049260052f4,more depressing,11,0,11
513cc296fdc9f035870015aa,51409129fdc9f04926000457,more depressing,11,0,11
50f6145abeb2fed910000717,513f2e9cfdc9f0358700dc49,safer,11,0,11
513cbb38fdc9f03587000ea2,514143dcfdc9f04926006448,more depressing,11,0,11
513d61c0fdc9f03587003ea9,5141508ffdc9f04926007da4,safer,0,11,11
513925fc818ede1296001062,513d548bfdc9f03587002f2b,livelier,11,0,11
513e6d02fdc9f0358700c230,513f13f5fdc9f0358700cb9d,safer,0,11,11
50f4485dfdc9f065f0003f0e,513d9c6ffdc9f03587007d36,livelier,5,6,11
50f44866fdc9f065f0003fae,50f5e705fdc9f065f0006f7b,safer,1,10,11
513e5ffcfdc9f0358700b311,514147bffdc9f04926006b16,safer,0,11,11
513d69adfdc9f035870047f9,51413564fdc9f049260049c2,more boring,6,5,11
50f463cbfdc9f065f00043f7,50f46498fdc9f065f0004840,wealthier,2,9,11
50f5eeaffdc9f065f0008fed,5142275dfdc9f0492600865c,livelier,11,0,11
513d6bcdfdc9f03587004de7,513d7c22fdc9f03587006dc7,safer,10,1,11
50f46454fdc9f065f0004588,513d7dfbfdc9f035870072f1,safer,10,1,11
50f463c8fdc9f065f000437c,514136d1fdc9f04926004ce3,safer,10,1,11
50f5eba8fdc9f065f0008412,513d6162fdc9f03587003e2c,safer,1,10,11
50f42ef2fdc9f065f0002458,513d7842fdc9f035870060e0,safer,11,0,11
513d9c94fdc9f03587007db1,5140ca7afdc9f04926002853,livelier,3,8,11
5140d9b8fdc9f04926003c79,51421abcfdc9f04926008395,safer,0,11,11
50f42c81fdc9f065f0001e17,513cd18cfdc9f03587001e36,safer,0,11,11
50f5eab0fdc9f065f0007c3a,51409123fdc9f0492600044b,livelier,0,11,11
5140d8c4fdc9f04926003aa0,51413b20fdc9f049260058ab,livelier,1,10,11
50f5e87cfdc9f065f000730f,513e6a9cfdc9f0358700bf04,livelier,0,11,11
513d7c82fdc9f03587006f09,513f2e58fdc9f0358700dbc0,wealthier,11,0,11
50f5eb66fdc9f065f000827f,513e6fa9fdc9f0358700c5dc,livelier,5,6,11
513d9c3ffdc9f03587007c90,513e6dcffdc9f0358700c350,safer,11,0,11
513da0c8fdc9f03587008a2d,513f1354fdc9f0358700cac3,safer,2,9,11
50f56362fdc9f065f0005d0e,513e1ff5fdc9f0358700a092,wealthier,11,0,11
513d3058fdc9f03587002712,513da043fdc9f03587008929,safer,0,11,11
51414f9efdc9f04926007b33,51422e29fdc9f04926008cc4,livelier,0,11,11
50f56360fdc9f065f0005cd3,513f140dfdc9f0358700cbc1,safer,5,6,11
513d9f62fdc9f03587008719,513f2d35fdc9f0358700d9c9,more depressing,10,1,11
513d9dedfdc9f03587008238,513e6b17fdc9f0358700bfaa,safer,11,0,11
50f5e648fdc9f065f0006c4c,51408fd9fdc9f04926000192,safer,0,11,11
513d9f51fdc9f035870086da,5185cd79fdc9f03fd5000d32,more beautiful,9,2,11
5140ce8cfdc9f04926003063,5141460cfdc9f0492600670a,wealthier,11,0,11
5140d392fdc9f049260033f1,514142f3fdc9f0492600634d,more depressing,0,11,11
51409dbffdc9f04926001355,51409e7bfdc9f0492600143c,livelier,11,0,11
5140b8a3fdc9f04926001cbe,51414637fdc9f04926006770,more depressing,11,0,11
5140b846fdc9f04926001bf7,5140c9aafdc9f049260025d9,safer,0,11,11
513d4a16fdc9f03587002de0,51414d89fdc9f049260075fc,more beautiful,4,7,11
50f42b53fdc9f065f0001393,513d78dbfdc9f035870062ed,more depressing,11,0,11
513ce66bfdc9f03587002270,513f2a3cfdc9f0358700d4e2,more beautiful,4,6,10
50f42b52fdc9f065f000136c,513d6b93fdc9f03587004d5e,more beautiful,0,10,10
513ce995fdc9f03587002314,513f2d09fdc9f0358700d983,more boring,10,0,10
5140d5eefdc9f049260035ad,514136d5fdc9f04926004cec,livelier,0,10,10
50f433d1fdc9f065f0002700,513cb825fdc9f03587000bc0,livelier,7,3,10
50f433dbfdc9f065f00027e4,51409884fdc9f04926000cc3,more boring,1,9,10
513d4e42fdc9f03587002e66,513d7c96fdc9f03587006f47,more depressing,0,10,10
513cc762fdc9f03587001a36,513d7e08fdc9f0358700730b,safer,6,4,10
513cd302fdc9f03587001e82,513f1169fdc9f0358700c827,safer,3,7,10
50f5eb6ffdc9f065f000833a,513e6081fdc9f0358700b3e0,safer,1,9,10
50f5eb62fdc9f065f0008236,50f60879beb2fed6f800056b,livelier,0,10,10
50f5609bfdc9f065f00052a8,513e5f35fdc9f0358700b1e7,safer,10,0,10
513d9afefdc9f03587007883,5185ce7bfdc9f03fd5000e34,safer,10,0,10
50f5e76afdc9f065f0007164,51414674fdc9f04926006802,safer,1,9,10
513d7d6dfdc9f035870071c5,513e5de3fdc9f0358700af06,wealthier,10,0,10
50f561f3fdc9f065f00057ab,513f298cfdc9f0358700d3b2,wealthier,0,10,10
513e1b1afdc9f0358700939f,513f2dd5fdc9f0358700dae7,safer,1,9,10
50f561cbfdc9f065f000572b,513cbcbcfdc9f03587001008,more boring,10,0,10
50f5644bfdc9f065f0006219,5140939bfdc9f049260007c8,more boring,10,0,10
50f56412fdc9f065f00060bb,51421985fdc9f04926008253,livelier,10,0,10
50f5e51afdc9f065f0006627,51409280fdc9f049260006b7,safer,1,9,10
50f5e526fdc9f065f00066b4,513d7d29fdc9f0358700711b,livelier,10,0,10
50f5e528fdc9f065f000671f,513cb612fdc9f035870009df,wealthier,0,10,10
513d9c9efdc9f03587007dd9,514150fefdc9f04926007ea9,livelier,0,10,10
51414b96fdc9f0492600710b,51422c6dfdc9f04926008b27,livelier,1,9,10
51408b0afdc9f0358700e857,51414d15fdc9f049260074c6,livelier,0,10,10
51414e44fdc9f049260077d8,51415068fdc9f04926007d39,livelier,8,2,10
513cbf6afdc9f0358700128f,513d9bb7fdc9f03587007ad6,more beautiful,0,10,10
51413879fdc9f04926005219,51421a83fdc9f0492600835a,more beautiful,10,0,10
513d5955fdc9f03587003381,513d61f2fdc9f03587003ee8,livelier,8,2,10
50f42baefdc9f065f00015c4,5141349afdc9f049260046fe,more beautiful,10,0,10
513cbceefdc9f0358700102f,513d6d0dfdc9f035870050ba,livelier,10,0,10
513f2a4bfdc9f0358700d4fe,514135adfdc9f04926004ac8,more boring,10,0,10
50f42ef2fdc9f065f0002443,513d9b6dfdc9f035870079e6,safer,1,9,10
514148eafdc9f04926006d56,51421832fdc9f049260080f3,safer,0,10,10
50f43aa4fdc9f065f0002e59,513e5cd4fdc9f0358700ac13,safer,8,2,10
50f43b6ffdc9f065f00030a6,513d5fbffdc9f03587003c29,safer,4,6,10
513f2ebcfdc9f0358700dc7e,5140cce3fdc9f04926002eca,wealthier,10,0,10
50f43ba7fdc9f065f00032a5,5140c950fdc9f049260024cd,wealthier,10,0,10
513f2db3fdc9f0358700daae,51422971fdc9f04926008857,more beautiful,9,1,10
50f5ed99fdc9f065f0008e26,513f3251fdc9f0358700e066,more depressing,1,9,10
513e1f59fdc9f03587009ede,51408fddfdc9f0492600019d,more depressing,9,1,10
50f55e97fdc9f065f0004d41,513e6e29fdc9f0358700c3d2,livelier,0,10,10
50f55e6efdc9f065f0004c86,5185d3c4fdc9f03fd5001325,more boring,10,0,10
513e5bbefdc9f0358700a926,51414007fdc9f04926006057,wealthier,0,10,10
50f55e32fdc9f065f0004b05,514227aafdc9f049260086a7,wealthier,0,10,10
513d6cabfdc9f03587005015,513f1327fdc9f0358700ca8a,more boring,2,8,10
50f5ed9afdc9f065f0008e37,51409d60fdc9f049260012e3,more boring,10,0,10
50f5eafafdc9f065f0007f3c,513d9ddffdc9f03587008209,more beautiful,8,2,10
50f5609afdc9f065f000526a,513ccd29fdc9f03587001d67,more boring,0,10,10
50f5eaaafdc9f065f0007bdf,5140930ffdc9f0492600073a,safer,10,0,10
50f5eb19fdc9f065f0007f78,513d5dd5fdc9f03587003973,livelier,1,9,10
50f448b1fdc9f065f00041e1,50f5eaa3fdc9f065f0007b5c,more depressing,10,0,10
50f448b1fdc9f065f00041e7,513e1c10fdc9f0358700962f,safer,7,3,10
50f5ec38fdc9f065f0008824,513e2043fdc9f0358700a163,more boring,1,9,10
50f5ed63fdc9f065f0008cb4,513cc584fdc9f0358700187f,more boring,10,0,10
513cb2acfdc9f03587000691,51422a46fdc9f0492600890e,livelier,0,10,10
50f6086abeb2fed6f800043c,5141471cfdc9f0492600699e,safer,10,0,10
50f6145dbeb2fed91000073b,5185cf09fdc9f03fd5000ebf,safer,0,10,10
513cc1e0fdc9f035870014fc,513d6a13fdc9f0358700494c,more boring,0,10,10
513cbfabfdc9f035870012d6,513f2fc4fdc9f0358700de2a,safer,0,10,10
50f42eeffdc9f065f000241b,50f56260fdc9f065f00059c7,livelier,1,9,10
513d68edfdc9f03587004546,5140b776fdc9f049260019e7,wealthier,10,0,10
50f60c58beb2fed910000344,513d6b38fdc9f03587004c80,more beautiful,0,10,10
513e6585fdc9f0358700b998,5185d234fdc9f03fd50011a0,safer,0,10,10
513cc8b2fdc9f03587001b71,51413998fdc9f049260054df,safer,6,3,9
50f3981ffdc9f065f0000df6,50f5eb65fdc9f065f000827d,safer,0,9,9
50f42b4ffdc9f065f00012b8,513d9c46fdc9f03587007ca8,wealthier,8,1,9
50f39820fdc9f065f0000e0f,513e1c5bfdc9f03587009704,safer,0,9,9
513ce4bbfdc9f03587002222,513d32fdfdc9f0358700291c,livelier,3,6,9
513cde0cfdc9f035870020d5,51409173fdc9f049260004f4,safer,9,0,9
513cd33cfdc9f03587001e8c,51414953fdc9f04926006dc5,more boring,9,0,9
50f42c6afdc9f065f0001bdc,50f43ab0fdc9f065f0002f34,livelier,0,9,9
50f5e5d7fdc9f065f0006aaa,5140d844fdc9f0492600399d,safer,1,8,9
514140b0fdc9f049260060f5,51414e26fdc9f04926007787,safer,9,0,9
51409e22fdc9f049260013d0,5140d973fdc9f04926003bf4,safer,0,9,9
50f43477fdc9f065f000281c,50f60b87beb2fed910000001,more boring,0,9,9
51409346fdc9f04926000774,5185d450fdc9f03fd50013b6,safer,0,9,9
514092b1fdc9f049260006e0,5185cd67fdc9f03fd5000d1e,more depressing,9,0,9
51409b32fdc9f04926001039,51409ba1fdc9f049260010cc,safer,0,9,9
513cd514fdc9f03587001eef,513d6e79fdc9f035870052f5,more boring,3,6,9
50f5e89afdc9f065f00073fc,513e6bf5fdc9f0358700c0cc,safer,8,1,9
50f42c49fdc9f065f0001a15,513d6b50fdc9f03587004cb9,wealthier,9,0,9
50f5e769fdc9f065f0007134,51422d90fdc9f04926008c3d,safer,3,6,9
50f563cffdc9f065f0005ea4,513e1a29fdc9f0358700912d,more boring,9,0,9
50f5e565fdc9f065f0006827,5140c9d5fdc9f0492600265c,wealthier,4,5,9
50f5e58ffdc9f065f0006a3b,51409e78fdc9f0492600143b,livelier,0,9,9
513d9cccfdc9f03587007e71,514146d0fdc9f049260068dd,more beautiful,1,8,9
513d6ba4fdc9f03587004d8a,513d9ddcfdc9f035870081ff,livelier,8,1,9
51413431fdc9f0492600457c,51414b9dfdc9f0492600711b,more depressing,0,9,9
513d6b8dfdc9f03587004d4f,5140d655fdc9f04926003642,livelier,0,9,9
50f5eeadfdc9f065f0008fc3,513d4965fdc9f03587002dc7,safer,2,7,9
50f46498fdc9f065f0004856,513d35befdc9f03587002b1d,more beautiful,0,9,9
513e225efdc9f0358700a54c,514139dafdc9f04926005575,wealthier,0,9,9
50f42c81fdc9f065f0001e17,5140ce73fdc9f0492600304c,wealthier,9,0,9
50f5e706fdc9f065f0006f95,50f5e8a5fdc9f065f0007426,livelier,0,9,9
50f5eb41fdc9f065f0008116,51408c46fdc9f0358700eac7,more beautiful,8,1,9
513d9c94fdc9f03587007db4,514133d7fdc9f04926004449,livelier,0,9,9
50f5e6c4fdc9f065f0006dd0,513d6c2ffdc9f03587004ee2,safer,8,1,9
513d7c06fdc9f03587006d6a,513d9c8efdc9f03587007da4,livelier,6,3,9
50f5ead0fdc9f065f0007d71,513d796efdc9f035870064c5,more depressing,0,9,9
50f5ead2fdc9f065f0007d96,513d5d32fdc9f03587003854,livelier,9,0,9
50f5eac7fdc9f065f0007cc3,513e6270fdc9f0358700b6c5,more depressing,0,9,9
50f5eaccfdc9f065f0007d1d,513e202afdc9f0358700a11b,wealthier,0,9,9
50f42c12fdc9f065f0001837,50f42c7efdc9f065f0001d5f,safer,9,0,9
50f42c73fdc9f065f0001ca4,50f60b97beb2fed9100000f7,safer,8,1,9
513d9e2efdc9f03587008314,5140ba18fdc9f04926001f6e,wealthier,5,4,9
513d9df5fdc9f03587008256,513d9e06fdc9f0358700828e,more beautiful,9,0,9
50f5e51efdc9f065f0006678,50f5eaa3fdc9f065f0007b55,more beautiful,9,0,9
50f5e584fdc9f065f0006960,50f5e895fdc9f065f0007389,safer,0,9,9
513d9dbdfdc9f0358700819d,51414ce0fdc9f0492600743f,livelier,1,8,9
50f561fafdc9f065f0005825,51413762fdc9f04926004ed0,safer,8,1,9
513e1df7fdc9f03587009b33,5140ce7cfdc9f04926003052,wealthier,0,9,9
50f561c4fdc9f065f00056b3,50f563d4fdc9f065f0005f0e,more boring,9,0,9
513e1bf8fdc9f035870095f6,513e5e67fdc9f0358700b06c,safer,0,9,9
50f5e902fdc9f065f000764d,5140d97ffdc9f04926003c09,safer,0,9,9
50f5e880fdc9f065f000736d,513f29f0fdc9f0358700d45b,safer,0,9,9
50f5ec0dfdc9f065f0008648,51409a07fdc9f04926000ebf,safer,1,8,9
50f5ec39fdc9f065f0008833,514148fefdc9f04926006d6d,livelier,4,5,9
50f5ebcafdc9f065f0008544,513d9dc9fdc9f035870081c0,safer,0,9,9
50f607d2beb2fed6f8000284,513e1f6bfdc9f03587009f12,safer,1,8,9
50f6086bbeb2fed6f8000450,5140ca4afdc9f049260027c4,more depressing,0,9,9
513d6883fdc9f035870043d0,51408bccfdc9f0358700e9df,livelier,0,9,9
513d68dcfdc9f03587004509,513d9ee0fdc9f0358700855d,more boring,1,8,9
50f44806fdc9f065f0003c69,513d3468fdc9f03587002a1e,livelier,8,1,9
513f1235fdc9f0358700c92e,514098f8fdc9f04926000d59,wealthier,9,0,9
514134c7fdc9f049260047a1,51421a4afdc9f0492600831e,more boring,0,9,9
513cb626fdc9f035870009f2,513e5e4ffdc9f0358700b024,livelier,5,4,9
513e6efafdc9f0358700c4e5,5185d0e6fdc9f03fd5001069,safer,9,0,9
513f10e3fdc9f0358700c77a,514094defdc9f049260008fe,livelier,9,0,9
50f44813fdc9f065f0003db6,50f5e63dfdc9f065f0006b8a,safer,5,4,9
513d7a14fdc9f035870066ec,5140cb7efdc9f04926002b89,safer,0,9,9
50f463c8fdc9f065f0004389,514147b6fdc9f04926006afe,safer,8,1,9
50f42eb2fdc9f065f0002373,51413589fdc9f04926004a42,safer,9,0,9
50f448b4fdc9f065f00041f6,513cb767fdc9f03587000b12,more depressing,0,9,9
513e65b0fdc9f0358700b9d8,5185cd61fdc9f03fd5000d1a,livelier,8,1,9
50f5ed57fdc9f065f0008c40,513da041fdc9f03587008923,more depressing,1,8,9
513d7852fdc9f03587006119,51415020fdc9f04926007c81,livelier,0,9,9
513d78b1fdc9f03587006256,51414fd5fdc9f04926007bc1,livelier,0,9,9
50f4455efdc9f065f000343a,50f56430fdc9f065f000615f,safer,0,9,9
513cc1cefdc9f035870014e9,513e1c3ffdc9f035870096b7,more depressing,0,9,9
50f42c0efdc9f065f00017ce,51422d95fdc9f04926008c41,livelier,2,7,9
50f42de0fdc9f065f0002296,513d68fffdc9f03587004586,more depressing,0,9,9
513cbda2fdc9f035870010da,513d6a33fdc9f035870049b8,more depressing,1,8,9
513f2b29fdc9f0358700d662,5140d310fdc9f04926003372,livelier,1,8,9
50f439f9fdc9f065f0002e2a,5140cbc5fdc9f04926002c47,more depressing,9,0,9
50f43bacfdc9f065f00032f6,50f56361fdc9f065f0005cf8,safer,6,3,9
513f3137fdc9f0358700df79,51409028fdc9f04926000232,livelier,1,8,9
5141493bfdc9f04926006daa,514219c8fdc9f04926008293,livelier,1,8,9
51414d96fdc9f04926007621,5185cf25fdc9f03fd5000eda,safer,0,9,9
50e5f7d8d7c3df413b00059e,50f561f3fdc9f065f00057a8,livelier,0,9,9
514148eafdc9f04926006d56,51422df0fdc9f04926008c94,livelier,7,2,9
50f42c09fdc9f065f0001745,513d302cfdc9f035870026ec,more beautiful,8,0,8
50e748e5d7c3df413b0013db,513d5e32fdc9f03587003a1b,safer,0,8,8
513e61f1fdc9f0358700b610,51409c5ffdc9f049260011af,safer,0,8,8
513d7826fdc9f03587006082,51421c09fdc9f049260084fb,livelier,2,6,8
513d7b00fdc9f035870069fb,5141505cfdc9f04926007d17,safer,8,0,8
50f5eb47fdc9f065f0008199,513d60c2fdc9f03587003d72,safer,8,0,8
513d5a9ffdc9f0358700341c,513d7f09fdc9f0358700751f,safer,0,8,8
50f5609bfdc9f065f00052c0,513d2f4efdc9f0358700263d,safer,0,8,8
513e5f8cfdc9f0358700b268,5141474dfdc9f04926006a0d,safer,6,2,8
50f563b8fdc9f065f0005e2e,5141446afdc9f049260064d5,more beautiful,6,2,8
5140b827fdc9f04926001bb0,5142280cfdc9f04926008703,livelier,1,7,8
513e1ff7fdc9f0358700a099,513e211dfdc9f0358700a3ac,wealthier,0,8,8
513d9eebfdc9f03587008581,51413a57fdc9f049260056ad,safer,7,1,8
50f561cbfdc9f065f0005737,513cbc9afdc9f03587000fe9,safer,0,8,8
50f5e689fdc9f065f0006d03,51415131fdc9f04926007f1c,livelier,1,7,8
513cc042fdc9f03587001369,513f2f40fdc9f0358700dd4e,safer,8,0,8
513d9f55fdc9f035870086eb,51409ac5fdc9f04926000faf,safer,0,8,8
50f5611cfdc9f065f00053fe,513d7db5fdc9f03587007255,more beautiful,3,5,8
51414773fdc9f04926006a65,51414f0bfdc9f049260079c7,wealthier,0,8,8
513d7c36fdc9f03587006e09,51414ff4fdc9f04926007c0e,safer,7,1,8
50f5eac4fdc9f065f0007c86,513f29a4fdc9f0358700d3df,livelier,0,8,8
51408c86fdc9f0358700eb40,51413587fdc9f04926004a3b,safer,8,0,8
513d6872fdc9f0358700438c,513f130bfdc9f0358700ca5f,safer,8,0,8
513cc3a2fdc9f035870016b6,513d9ac7fdc9f035870077d6,livelier,0,8,8
513d6d69fdc9f0358700514b,5140b6d4fdc9f0492600182a,safer,7,1,8
50f5e75cfdc9f065f000706b,513cbac7fdc9f03587000e34,livelier,0,8,8
513d6d9afdc9f0358700519a,513d9c5ffdc9f03587007d00,safer,0,8,8
50f43527fdc9f065f0002bc9,5140dbfcfdc9f04926003f6d,safer,0,8,8
50f5e6c3fdc9f065f0006daf,513cc06efdc9f03587001396,livelier,7,1,8
51413c69fdc9f04926005b1a,5185cf79fdc9f03fd5000f31,wealthier,8,0,8
513d78f5fdc9f03587006344,51414194fdc9f049260061da,more boring,0,8,8
50f46482fdc9f065f0004672,513e1c0dfdc9f03587009629,safer,0,8,8
50f56448fdc9f065f00061cb,50f60e70beb2fed910000614,livelier,0,8,8
513d56d1fdc9f03587003055,5141417ffdc9f049260061c5,livelier,6,2,8
513d787ffdc9f035870061b1,513e1b36fdc9f035870093f7,livelier,0,8,8
513d7c91fdc9f03587006f3a,51414fc7fdc9f04926007b9b,safer,8,0,8
513e21affdc9f0358700a488,51413abefdc9f049260057ac,livelier,0,8,8
50f5eaf3fdc9f065f0007eb0,513e6b31fdc9f0358700bfce,wealthier,0,8,8
50f55e6bfdc9f065f0004c4b,5140da17fdc9f04926003d47,safer,6,2,8
50f55e54fdc9f065f0004be3,513f151bfdc9f0358700cd3f,livelier,8,0,8
50f447cdfdc9f065f0003a00,5140939bfdc9f049260007c8,more beautiful,8,0,8
513d69e3fdc9f035870048ab,5142188cfdc9f04926008157,safer,8,0,8
513e6bdcfdc9f0358700c0af,513f2db2fdc9f0358700daac,safer,2,6,8
50f447d0fdc9f065f0003a54,50f46498fdc9f065f0004837,safer,8,0,8
513d59defdc9f035870033c5,513d9e0dfdc9f035870082a7,more depressing,8,0,8
51408f6efdc9f049260000c3,5140c9fffdc9f049260026d5,safer,8,0,8
5140989ffdc9f04926000ce4,5185d4b4fdc9f03fd5001410,wealthier,8,0,8
513cbe25fdc9f03587001154,513cdc14fdc9f0358700206d,more boring,8,0,8
50f5ec38fdc9f065f0008812,514134b0fdc9f0492600474f,more depressing,8,0,8
50f5ec40fdc9f065f00088bd,513d4e0afdc9f03587002e60,more boring,0,8,8
513d9f01fdc9f035870085d1,513f2ccffdc9f0358700d927,safer,1,7,8
513d9ed8fdc9f0358700853c,514141f2fdc9f0492600623f,livelier,0,8,8
513cbbcefdc9f03587000f28,51422de6fdc9f04926008c8b,livelier,1,7,8
51413598fdc9f04926004a77,51414600fdc9f049260066f3,more boring,8,0,8
51413705fdc9f04926004d87,51414e38fdc9f049260077b3,safer,8,0,8
50f42c7ffdc9f065f0001dc0,513da077fdc9f0358700899d,more depressing,7,1,8
513f10d6fdc9f0358700c768,51409de3fdc9f04926001389,livelier,7,1,8
50f5e8fefdc9f065f00075f3,5185d1a5fdc9f03fd500111c,more depressing,8,0,8
50f44808fdc9f065f0003cb8,513d389afdc9f03587002c69,livelier,6,2,8
50f44806fdc9f065f0003c63,513e5dc6fdc9f0358700aeb4,more depressing,0,8,8
50f43aadfdc9f065f0002efb,50f43bb0fdc9f065f0003351,livelier,5,3,8
5140caf1fdc9f049260029cb,5141483efdc9f04926006c49,livelier,6,2,8
513e1f41fdc9f03587009e9c,51413ce8fdc9f04926005c0c,safer,8,0,8
50f5e647fdc9f065f0006c09,513d54e1fdc9f03587002f3b,livelier,8,0,8
513d9d4afdc9f03587008009,513e5df3fdc9f0358700af2f,livelier,3,5,8
513d7dd6fdc9f0358700729b,5140b83bfdc9f04926001bda,livelier,7,1,8
513d7e84fdc9f0358700740e,51413404fdc9f049260044dd,wealthier,8,0,8
50f5e880fdc9f065f0007370,513d35c3fdc9f03587002b21,safer,8,0,8
50f46496fdc9f065f00047cf,5185ceb0fdc9f03fd5000e63,livelier,8,0,8
513e6e5bfdc9f0358700c417,51414850fdc9f04926006c75,safer,1,7,8
50f5e560fdc9f065f00067ae,513cdf79fdc9f0358700212b,more boring,8,0,8
50f5e55efdc9f065f0006766,513f2ee0fdc9f0358700dcb8,livelier,6,2,8
50f5e567fdc9f065f000685b,5140cc62fdc9f04926002db5,safer,6,2,8
5140d209fdc9f0492600327a,51413498fdc9f049260046f8,more beautiful,0,8,8
513e2363fdc9f0358700a67f,513e6107fdc9f0358700b4b5,wealthier,2,6,8
513e5bf0fdc9f0358700a9ab,513e61dcfdc9f0358700b5f0,wealthier,8,0,8
513e2312fdc9f0358700a624,5140b9aafdc9f04926001ec5,wealthier,0,8,8
513cb852fdc9f03587000be9,513f28fdfdc9f0358700d2ba,livelier,5,3,8
513cba36fdc9f03587000daf,513d2cd7fdc9f0358700246a,wealthier,7,1,8
513d5ee0fdc9f03587003b12,513f2ec1fdc9f0358700dc89,wealthier,8,0,8
513d6a87fdc9f03587004ab3,5141436bfdc9f049260063d7,safer,8,0,8
513d6a87fdc9f03587004ab3,51414bcffdc9f04926007194,safer,8,0,8
50f42b51fdc9f065f0001344,513e5c89fdc9f0358700ab4c,more boring,0,8,8
513e1b21fdc9f035870093b2,5140ce32fdc9f04926003012,safer,1,7,8
513cdb26fdc9f03587002034,513d6b38fdc9f03587004c81,livelier,8,0,8
513ce2c5fdc9f035870021ca,51413372fdc9f049260042dd,more boring,7,1,8
50f433c1fdc9f065f000260d,51413accfdc9f049260057d4,safer,0,8,8
50f56269fdc9f065f0005a50,513d9e5cfdc9f035870083a5,more boring,8,0,8
513e1babfdc9f03587009525,5141345ffdc9f0492600462c,safer,0,8,8
513e1c6bfdc9f0358700972a,5140cc92fdc9f04926002e2a,safer,5,3,8
513d2fdcfdc9f035870026ae,513f2b52fdc9f0358700d6a4,safer,5,3,8
50e748e6d7c3df413b001400,50f433c6fdc9f065f0002681,more depressing,0,8,8
51414baffdc9f04926007142,51415100fdc9f04926007eaf,safer,0,8,8
513e1c12fdc9f03587009635,513e215efdc9f0358700a429,livelier,0,8,8
513ceea5fdc9f03587002403,513d2d78fdc9f035870024e4,livelier,8,0,8
513d3050fdc9f0358700270b,513d7c15fdc9f03587006d97,livelier,0,8,8
5141505efdc9f04926007d1c,51422df6fdc9f04926008c98,more beautiful,2,6,8
513d792cfdc9f035870063f9,513f147cfdc9f0358700cc5b,safer,8,0,8
513d7940fdc9f03587006442,513f2993fdc9f0358700d3c3,safer,0,8,8
513e5f4afdc9f0358700b204,513f2f18fdc9f0358700dd10,livelier,1,7,8
50f448a4fdc9f065f00040c8,5140c9cdfdc9f04926002642,safer,0,8,8
50f448a5fdc9f065f00040d6,513d68d9fdc9f03587004500,safer,6,2,8
50f448a5fdc9f065f00040dc,51422e11fdc9f04926008cb0,livelier,8,0,8
51409c7bfdc9f049260011d7,514134b1fdc9f04926004751,more beautiful,8,0,8
513cc886fdc9f03587001b49,5141344cfdc9f049260045de,safer,0,8,8
513cd8acfdc9f03587001fb6,514134d5fdc9f049260047da,livelier,8,0,8
51408fd9fdc9f04926000193,51415044fdc9f04926007cda,livelier,0,7,7
513d5c3ffdc9f035870036a4,513f2965fdc9f0358700d369,livelier,5,2,7
513cc130fdc9f03587001458,513f2e84fdc9f0358700dc1b,more beautiful,2,5,7
513d595ffdc9f03587003383,514136c6fdc9f04926004ccd,livelier,0,7,7
513d5c15fdc9f0358700365d,5140c8d1fdc9f04926002356,livelier,5,2,7
50f43537fdc9f065f0002cfe,513e6281fdc9f0358700b6e0,more boring,7,0,7
513cc075fdc9f0358700139d,513e2004fdc9f0358700a0b9,livelier,5,2,7
50f5eca0fdc9f065f0008ad6,51414500fdc9f04926006576,livelier,0,7,7
50f44859fdc9f065f0003ec8,50f5ecf0fdc9f065f0008b32,wealthier,7,0,7
50f4485dfdc9f065f0003f43,513cc9f2fdc9f03587001c9d,livelier,6,1,7
513cc1c8fdc9f035870014e6,51409164fdc9f049260004d6,more depressing,0,7,7
513d788ffdc9f035870061e3,514133d6fdc9f04926004444,safer,0,7,7
513d7bdffdc9f03587006ce8,5140c987fdc9f04926002572,more beautiful,2,5,7
513d7c89fdc9f03587006f21,513e610afdc9f0358700b4ba,safer,3,4,7
513d790afdc9f03587006390,513e6d0cfdc9f0358700c23e,safer,1,6,7
50f5640dfdc9f065f0006048,5140b6f6fdc9f04926001886,livelier,3,4,7
513e1d08fdc9f035870098c8,5140cd3bfdc9f04926002f1c,safer,4,3,7
50f463c9fdc9f065f00043b7,50f5eb25fdc9f065f000805e,safer,1,6,7
50f463cafdc9f065f00043ec,51414b28fdc9f0492600704d,safer,6,1,7
50f46483fdc9f065f0004689,50f5e768fdc9f065f00070f6,safer,6,1,7
50f42efefdc9f065f0002537,513cbf88fdc9f035870012b2,livelier,4,3,7
50f42efdfdc9f065f00024c1,513d7d36fdc9f03587007148,more beautiful,0,7,7
50f42efffdc9f065f0002553,513d7c26fdc9f03587006dd9,livelier,0,7,7
513d5d3cfdc9f03587003864,513e1b46fdc9f03587009423,more beautiful,1,6,7
50f5eaeefdc9f065f0007e5c,5140d8fffdc9f04926003b0c,more beautiful,7,0,7
50f5eaaafdc9f065f0007bd1,5140ca6bfdc9f04926002826,livelier,3,4,7
513e5d71fdc9f0358700adc9,514150aefdc9f04926007df1,more boring,7,0,7
5140d8dbfdc9f04926003acf,5185d134fdc9f03fd50010b5,wealthier,7,0,7
50f46499fdc9f065f0004889,513e6c47fdc9f0358700c149,livelier,7,0,7
50f5eab1fdc9f065f0007c51,513e1a50fdc9f03587009194,safer,4,3,7
513d782dfdc9f03587006096,5142292dfdc9f04926008820,safer,7,0,7
513d7809fdc9f0358700601f,513e210cfdc9f0358700a37a,safer,7,0,7
50f44853fdc9f065f0003e4a,513e226cfdc9f0358700a55a,more depressing,3,4,7
50f44814fdc9f065f0003de5,50f56259fdc9f065f0005942,more beautiful,7,0,7
513d6e29fdc9f0358700527d,5140948bfdc9f049260008b0,livelier,0,7,7
513d6e58fdc9f035870052c4,5140ca5afdc9f049260027f0,livelier,6,1,7
513d7c9efdc9f03587006f60,5141458efdc9f04926006610,livelier,6,1,7
513d5c3efdc9f035870036a1,5185d0eefdc9f03fd5001070,more depressing,0,7,7
513cc334fdc9f03587001642,513f2ebdfdc9f0358700dc81,more boring,6,1,7
513d5c59fdc9f035870036d7,5140b694fdc9f0492600177b,safer,0,7,7
513d5b8afdc9f03587003573,51413855fdc9f049260051cf,safer,6,1,7
513d5bcafdc9f035870035e5,51409b46fdc9f04926001057,more depressing,0,7,7
514135c4fdc9f04926004b20,51413aa6fdc9f04926005775,more depressing,5,2,7
50f56087fdc9f065f0005186,513d6940fdc9f03587004674,wealthier,0,7,7
513e1fedfdc9f0358700a07b,51409a29fdc9f04926000eeb,safer,7,0,7
5140c98afdc9f0492600257b,51413db7fdc9f04926005dd2,safer,7,0,7
513d9d50fdc9f0358700801c,5142184dfdc9f04926008113,more beautiful,7,0,7
50f42c09fdc9f065f000175f,513cc0ecfdc9f03587001414,wealthier,0,7,7
513d5e12fdc9f035870039da,513f11defdc9f0358700c8bc,wealthier,5,2,7
513d5d85fdc9f035870038e8,513e1b74fdc9f0358700949e,safer,7,0,7
513e6f0cfdc9f0358700c501,513f2c67fdc9f0358700d878,more beautiful,0,7,7
513f1133fdc9f0358700c7dc,5140cb57fdc9f04926002b19,livelier,7,0,7
50f4480ffdc9f065f0003cdc,513cb91efdc9f03587000cae,safer,7,0,7
5140ba40fdc9f04926001f93,514150b7fdc9f04926007e05,more depressing,1,6,7
513d5e36fdc9f03587003a23,513d6a7bfdc9f03587004a96,more depressing,0,7,7
50f5eb67fdc9f065f0008291,513cd0f6fdc9f03587001e1b,more beautiful,7,0,7
50f42bbafdc9f065f0001694,513d9db1fdc9f03587008176,livelier,4,3,7
50f42c0afdc9f065f0001764,513d7881fdc9f035870061b8,safer,0,7,7
50f5eb43fdc9f065f000813a,513cda44fdc9f03587002009,wealthier,2,5,7
5140ca52fdc9f049260027d7,514149a3fdc9f04926006e1a,livelier,0,7,7
50f561fafdc9f065f0005812,513d7c8bfdc9f03587006f27,more boring,1,6,7
5140d81ffdc9f0492600394f,51414b28fdc9f0492600704d,livelier,7,0,7
513cc886fdc9f03587001b48,514092c5fdc9f049260006f1,safer,3,4,7
513d9cadfdc9f03587007e0b,5140da44fdc9f04926003d9f,livelier,7,0,7
513d7ba0fdc9f03587006c15,5140caaefdc9f049260028f4,safer,7,0,7
50f5eeadfdc9f065f0008fc9,513d7e20fdc9f03587007334,safer,7,0,7
513cc83afdc9f03587001b00,513d9c64fdc9f03587007d0f,wealthier,0,7,7
5140ca6ffdc9f04926002835,514147cdfdc9f04926006b35,livelier,0,7,7
513e1fd0fdc9f0358700a02a,5140d800fdc9f04926003919,livelier,0,7,7
513cbd92fdc9f035870010ca,5140b952fdc9f04926001e16,livelier,7,0,7
513d9e7dfdc9f03587008412,5140dae5fdc9f04926003e4b,safer,6,1,7
50f56268fdc9f065f0005a37,51413b07fdc9f04926005866,livelier,6,1,7
50f42ddffdc9f065f000225c,5140c8defdc9f04926002383,safer,7,0,7
50e748ead7c3df413b001466,513d9b24fdc9f035870078fc,more boring,7,0,7
50f55eb2fdc9f065f0004e48,50f5e70cfdc9f065f0007017,safer,6,1,7
51414767fdc9f04926006a4c,5185d3a5fdc9f03fd5001303,more beautiful,7,0,7
513d9d0afdc9f03587007f3f,5140b76cfdc9f049260019d0,safer,0,7,7
513d5f60fdc9f03587003bac,513d6b12fdc9f03587004c26,more beautiful,7,0,7
513f2dd5fdc9f0358700dae6,514094ebfdc9f0492600090f,safer,0,7,7
50f43baafdc9f065f00032d9,513d9af7fdc9f0358700786c,more beautiful,6,1,7
50e5faecd7c3df413b000754,50f5640efdc9f065f0006073,safer,7,0,7
513cb526fdc9f035870008f0,513cb6a0fdc9f03587000a63,livelier,1,6,7
513d7df7fdc9f035870072e7,513f151afdc9f0358700cd3d,safer,0,7,7
50e748e2d7c3df413b0013ab,51409d26fdc9f0492600129e,more depressing,0,7,7
50f5e8cafdc9f065f00074c5,51413a5efdc9f049260056be,livelier,0,7,7
50f5e8aafdc9f065f0007498,50f5ed53fdc9f065f0008bf4,safer,4,3,7
50f5e8c8fdc9f065f00074a9,5140d04afdc9f04926003212,livelier,7,0,7
50f6087abeb2fed6f8000577,5140c9cafdc9f04926002636,safer,0,7,7
50f6145dbeb2fed910000737,51422701fdc9f04926008609,safer,7,0,7
50f5e6fdfdc9f065f0006e91,50f6086ebeb2fed6f8000486,more depressing,0,7,7
513d9b71fdc9f035870079f2,5140dbf2fdc9f04926003f63,livelier,1,6,7
50f6011ebeb2fed6f8000188,51421c9afdc9f0492600859b,more depressing,2,5,7
50f6011fbeb2fed6f800018e,513d68c7fdc9f035870044c7,livelier,0,7,7
513d9bb8fdc9f03587007ad8,5141364dfdc9f04926004c2a,safer,7,0,7
513e5d06fdc9f0358700aca1,51409082fdc9f049260002f1,more beautiful,7,0,7
513d7d86fdc9f035870071f4,514148e2fdc9f04926006d4d,safer,3,4,7
50f4649afdc9f065f000489e,5141387dfdc9f04926005224,safer,7,0,7
50f46486fdc9f065f00046d9,513f2ca9fdc9f0358700d8e5,livelier,7,0,7
50f42c1cfdc9f065f0001918,513e604afdc9f0358700b38b,livelier,1,6,7
513d9d5bfdc9f03587008041,513e200ffdc9f0358700a0d6,livelier,3,4,7
50f60c3fbeb2fed910000150,513d9c61fdc9f03587007d07,wealthier,7,0,7
50f5e560fdc9f065f00067af,513e5c39fdc9f0358700aa75,livelier,1,6,7
50f43aaafdc9f065f0002eca,51408bfafdc9f0358700ea34,livelier,1,6,7
50f56450fdc9f065f0006295,513d9ff8fdc9f0358700887b,safer,5,2,7
50f5e51afdc9f065f000662f,5140ca8dfdc9f0492600288f,safer,6,1,7
50f61670beb2fed910000856,513e5c7ffdc9f0358700ab2d,safer,0,7,7
50f43bacfdc9f065f00032f6,51408b84fdc9f0358700e953,livelier,5,2,7
513d67cffdc9f03587004182,51413aeafdc9f0492600581e,safer,7,0,7
51392e28818ede129600128e,513d6dbafdc9f035870051ca,livelier,7,0,7
513d6199fdc9f03587003e76,5140dad6fdc9f04926003e37,livelier,4,3,7
513d6192fdc9f03587003e6c,513d784efdc9f0358700610b,more depressing,6,1,7
50f5e5d9fdc9f065f0006ac6,514139ebfdc9f0492600559d,livelier,0,7,7
50f4455ffdc9f065f0003446,50f5eb25fdc9f065f0008062,livelier,0,7,7
50f42c6afdc9f065f0001bd8,513d7ea9fdc9f03587007453,livelier,6,1,7
50f55e33fdc9f065f0004b1b,514134a8fdc9f04926004731,safer,7,0,7
513d697dfdc9f03587004752,5185d48efdc9f03fd50013f2,safer,0,7,7
513d9a82fdc9f035870076e9,513e6a5ffdc9f0358700beb1,livelier,5,2,7
50f5e76bfdc9f065f000719b,514134cafdc9f049260047b0,livelier,7,0,7
50f61456beb2fed9100006ea,513d4c66fdc9f03587002e2e,livelier,0,7,7
50f5e8a6fdc9f065f0007433,5140c8c8fdc9f0492600233b,wealthier,3,4,7
51392b36818ede12960011c7,513cc604fdc9f035870018f1,safer,0,7,7
51392b78818ede12960011d5,513cb602fdc9f035870009cd,wealthier,0,7,7
50f607e4beb2fed6f80003c2,51421c6afdc9f04926008561,livelier,7,0,7
50f607dbbeb2fed6f8000335,513e5dcafdc9f0358700aebe,safer,0,7,7
50f42c0cfdc9f065f0001799,5140d806fdc9f04926003924,wealthier,1,6,7
513d6a5afdc9f03587004a40,5140c93ffdc9f04926002498,wealthier,0,7,7
50f5e8a6fdc9f065f0007443,514134aafdc9f04926004736,more boring,3,4,7
513e5c19fdc9f0358700aa1f,513e60fafdc9f0358700b4a1,more beautiful,0,7,7
513f2a03fdc9f0358700d47d,514134edfdc9f0492600482b,wealthier,0,7,7
513e2333fdc9f0358700a646,5140daaafdc9f04926003e02,more beautiful,0,7,7
513f28a4fdc9f0358700d225,51413d0ffdc9f04926005c58,more boring,0,7,7
50f42bb5fdc9f065f0001658,51422cf6fdc9f04926008bab,livelier,0,7,7
50f42bb5fdc9f065f000166c,50f5ee9bfdc9f065f0008f56,livelier,0,7,7
50f42efcfdc9f065f000249c,5185cbf9fdc9f03fd5000bba,more depressing,0,7,7
50f60b93beb2fed9100000c3,5141341dfdc9f0492600452e,safer,6,1,7
513d6a64fdc9f03587004a5d,513f2b2ffdc9f0358700d669,wealthier,7,0,7
5140d50afdc9f04926003419,5140d966fdc9f04926003bda,safer,0,7,7
50f6167abeb2fed910000901,513cc9ccfdc9f03587001c74,more beautiful,0,7,7
50f56364fdc9f065f0005d45,51415188fdc9f04926007fb6,more boring,0,7,7
50f56360fdc9f065f0005cea,513d9a97fdc9f03587007725,safer,7,0,7
513e1a82fdc9f03587009220,51408c41fdc9f0358700eaba,wealthier,4,3,7
513925b2818ede129600104a,513d9cf4fdc9f03587007ef9,safer,7,0,7
513e1b80fdc9f035870094bf,514147effdc9f04926006b8f,safer,4,3,7
513d9ce0fdc9f03587007eb9,514132f6fdc9f04926004138,safer,7,0,7
50f56205fdc9f065f00058f6,513cc24afdc9f0358700155f,livelier,0,7,7
50f42b7bfdc9f065f00013b1,51422e20fdc9f04926008cbd,safer,0,7,7
50f5e640fdc9f065f0006bcc,50f60c43beb2fed9100001a2,more boring,7,0,7
50f5e5e0fdc9f065f0006b2d,50f60b8abeb2fed910000023,livelier,5,2,7
513cdf45fdc9f0358700211f,51408ab1fdc9f0358700e794,livelier,0,7,7
5140d714fdc9f04926003742,51414be6fdc9f049260071cc,livelier,0,7,7
513cd98efdc9f03587001fe6,513d6b96fdc9f03587004d63,livelier,5,2,7
50f43478fdc9f065f0002835,50f5eaf1fdc9f065f0007e94,safer,0,7,7
513e1e3ffdc9f03587009bed,5185d0ddfdc9f03fd5001062,wealthier,6,1,7
50f560f1fdc9f065f0005341,513d9fadfdc9f035870087c2,livelier,0,7,7
513cc4a4fdc9f035870017ab,513d5d97fdc9f03587003909,safer,1,6,7
513e1c74fdc9f03587009745,5140db1ffdc9f04926003e8d,safer,0,7,7
513d2e65fdc9f03587002591,513d7b26fdc9f03587006a79,safer,7,0,7
513d2f57fdc9f03587002643,513e217ffdc9f0358700a44c,more boring,7,0,7
513cc3fcfdc9f0358700170b,513d5f56fdc9f03587003ba1,livelier,6,1,7
50f42b4ffdc9f065f00012b4,51413698fdc9f04926004c8e,safer,0,7,7
513d9f55fdc9f035870086e9,513e5ccafdc9f0358700abfe,wealthier,0,7,7
513e1dc9fdc9f03587009ab9,513f2cc0fdc9f0358700d910,safer,1,6,7
50f55e97fdc9f065f0004d48,513d9b29fdc9f03587007907,livelier,3,4,7
50f55e7bfdc9f065f0004ce4,513d6ea5fdc9f0358700533a,more depressing,0,7,7
5140b7ccfdc9f04926001ae3,5140b96efdc9f04926001e4e,livelier,0,7,7
5140b8ecfdc9f04926001d49,51414f7afdc9f04926007ad8,more boring,5,2,7
50f4352afdc9f065f0002c0c,50f562e3fdc9f065f0005b5a,more depressing,6,1,7
51408f36fdc9f0492600004a,51414873fdc9f04926006cc8,more depressing,0,7,7
513e1bd4fdc9f03587009592,514149cafdc9f04926006e71,livelier,0,7,7
513cc5acfdc9f035870018a6,513d6c59fdc9f03587004f4c,more depressing,1,6,7
513e5e3cfdc9f0358700afef,514142f9fdc9f04926006351,wealthier,0,7,7
50f4349efdc9f065f0002a84,50f447d8fdc9f065f0003ac5,livelier,6,1,7
513e1d21fdc9f0358700990a,51408b79fdc9f0358700e938,more boring,0,7,7
50f5ebacfdc9f065f000846c,5140cc8ffdc9f04926002e23,more boring,0,7,7
513d7952fdc9f03587006470,5141510dfdc9f04926007ec9,wealthier,3,4,7
50f5612dfdc9f065f00054e7,513d9e88fdc9f03587008439,more beautiful,0,7,7
50f42eaefdc9f065f000231a,513d6b31fdc9f03587004c73,livelier,6,1,7
50e5f7d9d7c3df413b0005a7,513cc16cfdc9f03587001491,more boring,1,6,7
50f5eb26fdc9f065f0008074,513e64c4fdc9f0358700b89a,safer,1,6,7
513d7aaefdc9f035870068fb,51414be0fdc9f049260071bd,safer,7,0,7
513d5687fdc9f03587002fda,51415144fdc9f04926007f49,livelier,7,0,7
50f5eaf4fdc9f065f0007ecd,51409ad0fdc9f04926000fc1,wealthier,0,7,7
5141398efdc9f049260054c7,51414503fdc9f0492600657a,safer,0,7,7
513e647dfdc9f0358700b830,51421846fdc9f04926008109,more depressing,7,0,7
50f448adfdc9f065f0004187,513cb648fdc9f03587000a14,more boring,7,0,7
513e5e3bfdc9f0358700afed,513f152afdc9f0358700cd4f,wealthier,7,0,7
513d37f8fdc9f03587002c2b,51413903fdc9f0492600536e,safer,7,0,7
50f433d1fdc9f065f0002707,51422b6bfdc9f04926008a37,more depressing,5,2,7
51409bfefdc9f04926001137,51413c33fdc9f04926005ae0,wealthier,5,2,7
50f433dbfdc9f065f00027d5,513e1a7efdc9f03587009211,more beautiful,4,3,7
50f433dbfdc9f065f00027da,5141353dfdc9f04926004940,safer,7,0,7
51413a53fdc9f049260056a4,5185cf64fdc9f03fd5000f16,livelier,6,1,7
513d38d2fdc9f03587002c80,513d7a28fdc9f0358700672d,safer,1,6,7
50f5eb22fdc9f065f000802a,513d78cdfdc9f035870062bb,livelier,1,6,7
513d353bfdc9f03587002ab0,5185d323fdc9f03fd500127c,safer,0,7,7
513d3585fdc9f03587002aed,513e1bfbfdc9f03587009601,livelier,1,6,7
513d3598fdc9f03587002afb,513e5f3dfdc9f0358700b1ee,livelier,7,0,7
50f4349afdc9f065f0002a38,50f44803fdc9f065f0003c27,livelier,6,1,7
513d364afdc9f03587002b80,513d7c23fdc9f03587006dcd,safer,1,6,7
513cc88afdc9f03587001b4d,51414f1cfdc9f049260079f3,more boring,0,7,7
513cc824fdc9f03587001aeb,51414de2fdc9f049260076e7,wealthier,7,0,7
50f463c6fdc9f065f0004335,51414f6efdc9f04926007abf,wealthier,1,6,7
51422af5fdc9f049260089c3,51422bddfdc9f04926008aa0,safer,6,0,6
513d3036fdc9f035870026f4,513d9ad9fdc9f03587007811,wealthier,1,5,6
513d3290fdc9f035870028ce,51409c41fdc9f0492600118a,livelier,0,6,6
50f56268fdc9f065f0005a4a,50f5ebc6fdc9f065f00084e4,safer,1,5,6
513e1aa5fdc9f0358700927c,5140b9f1fdc9f04926001f42,safer,0,6,6
50f561fafdc9f065f0005816,513e65c3fdc9f0358700b9f1,wealthier,2,4,6
50f5619afdc9f065f00055d1,514092ddfdc9f0492600070d,wealthier,6,0,6
50f561cbfdc9f065f00056f8,513d5d04fdc9f03587003806,safer,0,6,6
513cd65cfdc9f03587001f31,513e6ecbfdc9f0358700c4a6,livelier,6,0,6
513cd54cfdc9f03587001efe,513e62f6fdc9f0358700b78f,more depressing,6,0,6
513cd556fdc9f03587001f01,513e1a67fdc9f035870091d2,safer,5,1,6
50f4347cfdc9f065f0002874,513cc090fdc9f035870013b7,wealthier,0,6,6
50f4347ffdc9f065f00028b0,50f43518fdc9f065f0002af1,more beautiful,6,0,6
513cdc52fdc9f03587002077,513e5fbcfdc9f0358700b2b0,more boring,6,0,6
513cddfafdc9f035870020d1,5140db83fdc9f04926003ef3,more boring,0,6,6
51409e0ffdc9f049260013ba,5141384cfdc9f049260051ba,safer,1,5,6
50f433cffdc9f065f00026dc,51408934fdc9f0358700e480,safer,6,0,6
513d2f40fdc9f03587002634,513e6517fdc9f0358700b90b,wealthier,0,6,6
51414cc4fdc9f049260073f3,5185d0a6fdc9f03fd500103a,livelier,0,6,6
50f5eb3cfdc9f065f00080b6,513d7ffcfdc9f0358700767b,wealthier,0,6,6
50f5eb63fdc9f065f000825a,513e1d57fdc9f03587009994,wealthier,0,6,6
50f5eb4bfdc9f065f00081d6,513e62dbfdc9f0358700b765,more depressing,0,6,6
50f433cdfdc9f065f00026b2,513f1207fdc9f0358700c8f8,more beautiful,1,5,6
50f42f01fdc9f065f00025d1,513ccb0efdc9f03587001cee,safer,4,2,6
513cc884fdc9f03587001b46,51414db9fdc9f0492600767b,wealthier,6,0,6
513cd02afdc9f03587001df6,514135c8fdc9f04926004b32,wealthier,0,6,6
50f5eb3efdc9f065f00080eb,51409105fdc9f04926000406,more boring,6,0,6
513d7b21fdc9f03587006a67,513da10bfdc9f03587008a81,wealthier,0,6,6
50f42c13fdc9f065f0001847,513d9cdafdc9f03587007ea2,livelier,0,6,6
50f5ebacfdc9f065f0008466,514133c7fdc9f0492600440e,more boring,0,6,6
50f5ec0efdc9f065f0008665,513d691dfdc9f035870045fa,livelier,6,0,6
50f5ec0ffdc9f065f0008675,51414cd8fdc9f0492600742c,more boring,6,0,6
50f5eba5fdc9f065f00083e1,50f5ebaafdc9f065f0008435,livelier,0,6,6
50f44868fdc9f065f000404f,50f5ed52fdc9f065f0008bd6,more boring,0,6,6
51409144fdc9f04926000491,5140cb03fdc9f04926002a07,safer,6,0,6
513cc614fdc9f03587001900,513d6939fdc9f03587004662,more boring,0,6,6
513d56b9fdc9f0358700302d,513e1dfcfdc9f03587009b3e,livelier,6,0,6
513cc586fdc9f03587001881,513d78ecfdc9f03587006324,safer,6,0,6
50f42b88fdc9f065f00014ef,50f4648efdc9f065f000477c,safer,0,6,6
51413875fdc9f04926005211,51414ccefdc9f04926007410,safer,1,5,6
51413a61fdc9f049260056c4,51415151fdc9f04926007f6b,more beautiful,4,2,6
50f42eaefdc9f065f000230b,51413a3dfdc9f04926005670,safer,0,6,6
513d9fbcfdc9f035870087eb,513e1fc9fdc9f0358700a014,livelier,1,5,6
513d9f42fdc9f035870086ab,513e1ed2fdc9f03587009d81,livelier,0,6,6
513e1dddfdc9f03587009aee,5140dc09fdc9f04926003f7c,more boring,0,6,6
513d9f76fdc9f0358700874a,51408c36fdc9f0358700eaa7,safer,0,6,6
513d9f82fdc9f03587008769,513e1ad8fdc9f035870092f4,livelier,1,5,6
50f56125fdc9f065f0005477,513d9c47fdc9f03587007cae,livelier,0,6,6
513d5671fdc9f03587002fb2,513f2cd2fdc9f0358700d92b,livelier,0,6,6
50f42c68fdc9f065f0001bab,51408b4afdc9f0358700e8d6,safer,5,1,6
5140ce3efdc9f0492600301c,514150bafdc9f04926007e0a,more beautiful,6,0,6
513d61e5fdc9f03587003ed9,513e1d55fdc9f03587009990,safer,6,0,6
513d6099fdc9f03587003d3e,51413474fdc9f04926004678,more boring,0,6,6
513d615efdc9f03587003e26,513f2e3dfdc9f0358700db96,safer,0,6,6
513d6199fdc9f03587003e76,513d9e19fdc9f035870082c8,livelier,0,6,6
513f2d77fdc9f0358700da45,51413a85fdc9f04926005723,more beautiful,0,6,6
5139295c818ede1296001141,51413a5bfdc9f049260056b7,livelier,4,2,6
513f28d5fdc9f0358700d26d,51414c9cfdc9f04926007390,wealthier,0,6,6
513f28f3fdc9f0358700d2a2,51413a26fdc9f04926005637,more boring,0,6,6
50f5e706fdc9f065f0006f8d,50f5ebadfdc9f065f0008473,more beautiful,6,0,6
513d9b09fdc9f035870078a6,51414c82fdc9f04926007355,livelier,0,6,6
50f5e75afdc9f065f000704f,51408c0efdc9f0358700ea5e,safer,5,1,6
513d9cdffdc9f03587007eb7,5140c8fbfdc9f049260023d1,safer,0,6,6
50f5e56dfdc9f065f0006906,50f5ec3efdc9f065f0008890,more depressing,2,4,6
5140d1eefdc9f0492600325d,514137a2fdc9f04926004fc2,livelier,0,6,6
50f60c3fbeb2fed91000014c,513cc344fdc9f03587001654,safer,1,5,6
513d69f0fdc9f035870048db,51414ff1fdc9f04926007c07,livelier,6,0,6
513f2951fdc9f0358700d33f,513f29effdc9f0358700d457,more beautiful,6,0,6
50f447cffdc9f065f0003a3b,513cc78cfdc9f03587001a5f,livelier,6,0,6
50f44508fdc9f065f00033e5,50f447d7fdc9f065f0003ac0,more depressing,0,6,6
50f60c52beb2fed9100002e4,51422cc6fdc9f04926008b7c,safer,6,0,6
50f60c54beb2fed910000309,513e1b7ffdc9f035870094bb,more depressing,0,6,6
50f60c48beb2fed91000020e,513d9bd4fdc9f03587007b29,more boring,6,0,6
513f2bcefdc9f0358700d773,51413381fdc9f04926004315,livelier,1,5,6
513f2c30fdc9f0358700d812,514140ebfdc9f0492600612d,more boring,0,6,6
50f44561fdc9f065f0003470,51409e2cfdc9f049260013dc,safer,6,0,6
513f2a88fdc9f0358700d557,5185d0affdc9f03fd5001042,safer,1,5,6
513f2ba7fdc9f0358700d72f,514137c6fdc9f04926005045,more beautiful,0,6,6
513d6980fdc9f0358700475c,513f28dafdc9f0358700d279,safer,0,6,6
513d6913fdc9f035870045d4,514147f7fdc9f04926006ba3,livelier,0,6,6
513d5f39fdc9f03587003b7d,5140b82bfdc9f04926001bba,more depressing,6,0,6
513d5ecbfdc9f03587003af5,51408912fdc9f0358700e42e,more beautiful,6,0,6
513d6053fdc9f03587003ce0,5140c8a9fdc9f049260022d8,safer,0,6,6
513cb67afdc9f03587000a42,513d30cefdc9f0358700276e,more beautiful,5,1,6
513cb728fdc9f03587000add,51414608fdc9f049260066fe,safer,5,1,6
513d5e89fdc9f03587003a9a,5141418bfdc9f049260061d3,livelier,5,1,6
50f43b92fdc9f065f000324e,51414efafdc9f049260079a0,wealthier,0,6,6
50f60876beb2fed6f8000526,513d6cd3fdc9f03587005058,safer,6,0,6
513d6a1cfdc9f03587004971,5140b6a8fdc9f049260017ac,safer,6,0,6
50f42bb5fdc9f065f000164a,514227ddfdc9f049260086dc,more depressing,0,6,6
513f321dfdc9f0358700e03e,5140c9defdc9f04926002675,more beautiful,0,6,6
513f3261fdc9f0358700e078,51414f8cfdc9f04926007b08,safer,6,0,6
513cb52efdc9f035870008f9,5140b6a0fdc9f0492600179a,more boring,1,5,6
5139285e818ede12960010fc,51409acefdc9f04926000fbe,safer,6,0,6
50f5e895fdc9f065f0007384,51414543fdc9f049260065bd,safer,2,4,6
513d6b2bfdc9f03587004c65,5140d9d8fdc9f04926003cc6,livelier,0,6,6
513d6b30fdc9f03587004c70,513e1ed1fdc9f03587009d80,safer,5,1,6
513d6a56fdc9f03587004a32,51409b5afdc9f04926001073,wealthier,6,0,6
513d6a9ffdc9f03587004af6,5141353efdc9f04926004943,livelier,4,2,6
50f607debeb2fed6f800035a,5185d4d3fdc9f03fd500142e,livelier,6,0,6
50f607debeb2fed6f800035f,513d7840fdc9f035870060da,livelier,6,0,6
50f60872beb2fed6f80004d8,51422c95fdc9f04926008b48,more boring,6,0,6
513cb5c4fdc9f0358700098c,514099e1fdc9f04926000e8d,safer,4,2,6
50f43badfdc9f065f000331e,513cb510fdc9f035870008d7,more beautiful,5,1,6
513f2cfefdc9f0358700d96f,514135b3fdc9f04926004ade,safer,5,1,6
513d7fadfdc9f03587007637,513d9dc0fdc9f035870081aa,safer,1,5,6
513d7fd3fdc9f03587007656,51413b16fdc9f04926005890,safer,0,6,6
513d9b17fdc9f035870078cf,513f2bf9fdc9f0358700d7bb,livelier,1,5,6
50f46497fdc9f065f00047fe,50f60875beb2fed6f800051a,safer,6,0,6
50f5e880fdc9f065f0007364,51392ad8818ede12960011ab,more boring,2,4,6
50f5e55dfdc9f065f0006758,513e216cfdc9f0358700a437,safer,1,5,6
50f5e567fdc9f065f0006862,51413656fdc9f04926004c38,safer,0,6,6
50f5e564fdc9f065f0006809,513d9c19fdc9f03587007c16,safer,1,5,6
513d9d89fdc9f035870080e3,51414028fdc9f0492600607a,more boring,6,0,6
50f56092fdc9f065f0005240,51414d81fdc9f049260075e3,more boring,0,6,6
50f56092fdc9f065f0005249,513d6a87fdc9f03587004ab4,more boring,5,1,6
50f42b83fdc9f065f0001499,513d9ae9fdc9f03587007845,livelier,2,4,6
513cba4afdc9f03587000dc2,513e6513fdc9f0358700b904,livelier,0,6,6
50f4648bfdc9f065f000474c,51414835fdc9f04926006c32,more boring,0,6,6
50f4648efdc9f065f0004779,513cc9ecfdc9f03587001c93,livelier,1,5,6
513e5d38fdc9f0358700ad2a,51413a28fdc9f0492600563e,livelier,6,0,6
50f42badfdc9f065f00015a1,513cc422fdc9f0358700172d,livelier,5,1,6
513d6b3afdc9f03587004c87,513e6099fdc9f0358700b404,more beautiful,6,0,6
50f5e400fdc9f065f000661c,51408f59fdc9f0492600009a,safer,4,2,6
513e1fa3fdc9f03587009fad,513e6e33fdc9f0358700c3e2,safer,0,6,6
513e1f2ffdc9f03587009e6a,513e5d60fdc9f0358700ad9c,more beautiful,6,0,6
513d7e7afdc9f035870073fa,51409c1ffdc9f04926001160,safer,6,0,6
513d7ec2fdc9f0358700748a,513e1a95fdc9f03587009254,safer,5,1,6
513d7de8fdc9f035870072c7,51414734fdc9f049260069d8,livelier,1,5,6
513d7df2fdc9f035870072db,514228bafdc9f049260087b1,livelier,0,6,6
50f5e8cffdc9f065f0007539,513e6c3efdc9f0358700c139,livelier,0,6,6
5140d90efdc9f04926003b25,5140da11fdc9f04926003d3b,more beautiful,6,0,6
513d7d46fdc9f03587007175,51409c0efdc9f0492600114a,more depressing,0,6,6
50f46498fdc9f065f0004844,513e65d4fdc9f0358700ba09,livelier,6,0,6
5140cc36fdc9f04926002d46,5141422ffdc9f04926006281,more boring,6,0,6
50f55eb0fdc9f065f0004e10,513d68ddfdc9f0358700450f,livelier,6,0,6
50f55eb1fdc9f065f0004e32,514145a5fdc9f0492600662d,livelier,5,1,6
50f5608dfdc9f065f00051e0,51408ab8fdc9f0358700e7a2,more boring,4,2,6
50f5e63dfdc9f065f0006b92,51408b25fdc9f0358700e88a,more beautiful,6,0,6
50f447d0fdc9f065f0003a57,513cc262fdc9f03587001578,livelier,0,6,6
50f447dafdc9f065f0003b46,5140981dfdc9f04926000c35,livelier,1,5,6
50f5e8dffdc9f065f0007550,513e1a0afdc9f035870090de,livelier,5,1,6
50f42ddefdc9f065f0002236,5140b74dfdc9f04926001979,more beautiful,4,2,6
513e1f65fdc9f03587009f03,5140d8befdc9f04926003a96,safer,6,0,6
50f42dddfdc9f065f0002219,50f5e6fbfdc9f065f0006e63,wealthier,6,0,6
513cbca2fdc9f03587000ff2,513d6b92fdc9f03587004d58,more beautiful,0,6,6
50f43b75fdc9f065f000312c,5140b8b9fdc9f04926001ce6,livelier,0,6,6
513f31e7fdc9f0358700e010,51414fe0fdc9f04926007bdb,safer,0,6,6
50f42efefdc9f065f000251d,50f5612efdc9f065f0005520,livelier,1,5,6
513d5c65fdc9f035870036e9,51413dc9fdc9f04926005dfe,wealthier,2,4,6
50f5eeaafdc9f065f0008f75,513d9c26fdc9f03587007c3e,safer,6,0,6
513e6f34fdc9f0358700c53c,51414249fdc9f0492600629e,more boring,0,6,6
50f44854fdc9f065f0003e62,514146c1fdc9f049260068b8,wealthier,6,0,6
513e7025fdc9f0358700c687,51408fb3fdc9f04926000145,safer,5,1,6
50f447fefdc9f065f0003bc9,514139b6fdc9f0492600552a,more boring,0,6,6
5140d850fdc9f049260039b5,51413560fdc9f049260049b8,more beautiful,0,6,6
50f5642dfdc9f065f000610d,514094b3fdc9f049260008d5,safer,0,6,6
50f42dddfdc9f065f000221f,513cc618fdc9f03587001904,safer,0,6,6
514133a8fdc9f049260043a6,514148e2fdc9f04926006d4e,livelier,0,6,6
513d6c65fdc9f03587004f6b,513e7024fdc9f0358700c686,livelier,0,6,6
50f5ed99fdc9f065f0008e20,50f6145fbeb2fed910000766,more depressing,0,6,6
513d6d45fdc9f03587005114,51422dd8fdc9f04926008c80,livelier,0,6,6
50f5ed59fdc9f065f0008c81,5140cb25fdc9f04926002a7a,wealthier,6,0,6
513d6c43fdc9f03587004f14,51409107fdc9f04926000408,livelier,0,6,6
50f5ee92fdc9f065f0008e85,5140925cfdc9f04926000691,more boring,6,0,6
50f5ed99fdc9f065f0008e1a,513d69c8fdc9f03587004857,safer,6,0,6
50f42bbafdc9f065f0001690,513d5dc1fdc9f03587003950,more beautiful,6,0,6
50f42bb0fdc9f065f00015df,5140d2d7fdc9f04926003339,livelier,1,5,6
513f1295fdc9f0358700c9c4,51413d74fdc9f04926005d40,safer,1,5,6
50f42ef2fdc9f065f0002443,50f43488fdc9f065f00028f9,safer,6,0,6
50f42eeffdc9f065f000241a,5141437ffdc9f049260063ea,safer,6,0,6
513d6ac2fdc9f03587004b53,51422715fdc9f04926008618,safer,0,6,6
50f42c0dfdc9f065f00017c9,5141389efdc9f04926005273,more boring,4,2,6
50f42c0ffdc9f065f00017ed,51409d3bfdc9f049260012bc,more beautiful,6,0,6
513d59d0fdc9f035870033bf,5185cebefdc9f03fd5000e72,more boring,6,0,6
513d5c36fdc9f03587003695,5185cbb3fdc9f03fd5000b75,safer,5,1,6
50f43536fdc9f065f0002cf1,50f5625ffdc9f065f000598d,livelier,6,0,6
50f43533fdc9f065f0002cbc,50f55e6cfdc9f065f0004c4c,safer,5,1,6
50f439f2fdc9f065f0002da8,51415141fdc9f04926007f41,more boring,0,6,6
50f5644bfdc9f065f0006219,50f5e684fdc9f065f0006c8f,safer,0,6,6
50f5644dfdc9f065f0006252,5140b661fdc9f049260016d2,safer,6,0,6
50f5ed56fdc9f065f0008c3d,513e6560fdc9f0358700b969,livelier,6,0,6
513d6e5dfdc9f035870052cc,513d9b0afdc9f035870078a8,livelier,6,0,6
513d6e89fdc9f03587005310,5140b733fdc9f04926001937,more depressing,6,0,6
50f44853fdc9f065f0003e3e,51392e6a818ede129600129c,wealthier,6,0,6
50f44851fdc9f065f0003e19,513f13e8fdc9f0358700cb8d,safer,1,5,6
51409065fdc9f049260002af,514134bdfdc9f0492600477f,more depressing,1,5,6
50f43528fdc9f065f0002bd8,5141409bfdc9f049260060e0,more boring,2,4,6
513cc084fdc9f035870013ab,513e5d3bfdc9f0358700ad31,livelier,2,4,6
50f46455fdc9f065f00045c8,513e657afdc9f0358700b98b,safer,0,6,6
50f46456fdc9f065f00045f0,513e5c66fdc9f0358700aaea,safer,4,2,6
513e5e05fdc9f0358700af5e,513f114ffdc9f0358700c800,safer,6,0,6
50f5ec41fdc9f065f00088d4,514138d2fdc9f049260052f1,wealthier,5,1,6
513d782bfdc9f03587006091,5140cdf2fdc9f04926002fd1,safer,6,0,6
513e6513fdc9f0358700b904,5140d8cdfdc9f04926003ab7,livelier,1,5,6
50f5ed5afdc9f065f0008c9d,513e5efdfdc9f0358700b197,more depressing,0,6,6
513d5cd2fdc9f035870037ae,513d6cc5fdc9f0358700503f,wealthier,0,6,6
513cbcecfdc9f0358700102c,513cbde2fdc9f03587001116,safer,5,1,6
50f43aaffdc9f065f0002f1a,51409c44fdc9f04926001190,safer,0,6,6
51408ac3fdc9f0358700e7b9,5140d9e4fdc9f04926003cd9,livelier,4,2,6
51408af2fdc9f0358700e826,51413356fdc9f0492600427b,livelier,0,6,6
513cbed2fdc9f035870011f8,513e5bb3fdc9f0358700a906,more boring,0,6,6
513cbf58fdc9f03587001277,5140da6cfdc9f04926003dc6,safer,4,2,6
513d7d15fdc9f035870070d9,513d9e4afdc9f03587008372,livelier,0,6,6
513d9eabfdc9f035870084ad,513e5cb7fdc9f0358700abc5,livelier,0,6,6
5140cd6cfdc9f04926002f4f,5185d44ffdc9f03fd50013b4,safer,0,6,6
513d9f12fdc9f0358700860a,514141cdfdc9f04926006218,livelier,0,6,6
5140cc6ffdc9f04926002dcf,5140d5effdc9f049260035b2,safer,2,4,6
513e1efefdc9f03587009df3,5140cb98fdc9f04926002bda,safer,1,5,6
5140b981fdc9f04926001e75,5141424bfdc9f049260062a2,more boring,6,0,6
51408c20fdc9f0358700ea80,51413bf4fdc9f04926005a89,safer,6,0,6
513d5738fdc9f03587003118,51415052fdc9f04926007cff,safer,0,6,6
513d7bd1fdc9f03587006cb8,51422856fdc9f0492600874f,livelier,0,6,6
50f43490fdc9f065f0002990,5140c89dfdc9f049260022af,livelier,5,1,6
51409935fdc9f04926000dae,5140c9d5fdc9f0492600265d,safer,6,0,6
50f563fbfdc9f065f0005f7c,513d6041fdc9f03587003cc9,more boring,0,6,6
5140cca7fdc9f04926002e5a,5140da3efdc9f04926003d92,livelier,0,6,6
50f42c7cfdc9f065f0001ce6,513e1e3cfdc9f03587009be9,safer,4,2,6
50f42c7cfdc9f065f0001ceb,50f44807fdc9f065f0003cab,safer,1,5,6
50f42c7cfdc9f065f0001d0f,513e6428fdc9f0358700b7bc,livelier,6,0,6
50f5ec3bfdc9f065f0008858,514135f1fdc9f04926004b95,livelier,2,4,6
50f5ecf2fdc9f065f0008b5c,513e21defdc9f0358700a4b9,safer,0,6,6
513e6520fdc9f0358700b914,514138e6fdc9f04926005324,more depressing,1,5,6
513e6c16fdc9f0358700c100,514134cdfdc9f049260047b8,safer,6,0,6
513d7c87fdc9f03587006f1a,513e1a6ffdc9f035870091e9,safer,0,6,6
513d7bfdfdc9f03587006d47,513e60c0fdc9f0358700b441,safer,0,6,6
50f5eae8fdc9f065f0007de7,513ce01dfdc9f03587002149,safer,6,0,6
513d7bd0fdc9f03587006cb3,513e1bfafdc9f035870095fd,safer,0,6,6
50f5e527fdc9f065f00066d9,513e606efdc9f0358700b3c3,more depressing,6,0,6
50f5e51bfdc9f065f0006647,51413437fdc9f0492600458f,livelier,0,6,6
513d9e38fdc9f03587008339,5141344efdc9f049260045ec,wealthier,4,2,6
50f5ed65fdc9f065f0008ceb,5140d921fdc9f04926003b48,more boring,0,6,6
50f4485dfdc9f065f0003f1e,513da056fdc9f0358700895a,safer,0,6,6
50f5ebcffdc9f065f00085b3,514093f9fdc9f04926000829,wealthier,6,0,6
50f5ebc7fdc9f065f0008502,513d364afdc9f03587002b81,safer,5,1,6
513d783ffdc9f035870060d8,5140cc2cfdc9f04926002d33,livelier,0,6,6
513e6220fdc9f0358700b655,51414c8cfdc9f04926007370,livelier,0,6,6
513e624efdc9f0358700b697,51414862fdc9f04926006ca4,more depressing,1,5,6
513e613afdc9f0358700b4ff,513f1098fdc9f0358700c710,safer,0,6,6
50f463c7fdc9f065f0004362,51413d87fdc9f04926005d66,more depressing,2,4,6
50f463b6fdc9f065f000427a,50f560fbfdc9f065f00053db,safer,0,6,6
50f463b9fdc9f065f00042b3,51413aebfdc9f04926005821,safer,6,0,6
50f42b50fdc9f065f00012df,514141a7fdc9f049260061f1,livelier,6,0,6
513d30e4fdc9f0358700277c,51409159fdc9f049260004c0,more boring,1,5,6
513e6289fdc9f0358700b6e8,5140cd50fdc9f04926002f2f,wealthier,1,5,6
513d7a71fdc9f03587006829,513f1117fdc9f0358700c7ba,livelier,1,5,6
513d7a7bfdc9f03587006849,513e6cddfdc9f0358700c204,safer,0,6,6
513e614bfdc9f0358700b515,51413373fdc9f049260042e1,more depressing,0,6,6
513e61eafdc9f0358700b608,513f2f94fdc9f0358700ddd7,more depressing,0,6,6
513e62e8fdc9f0358700b779,5140cc88fdc9f04926002e11,more depressing,0,6,6
50f563d0fdc9f065f0005eac,50f5eb17fdc9f065f0007f4b,livelier,6,0,6
50f563d0fdc9f065f0005ebd,513f3324fdc9f0358700e117,livelier,0,6,6
513d7a96fdc9f035870068ae,5140db09fdc9f04926003e75,more boring,1,5,6
513d7ad5fdc9f03587006976,51409038fdc9f04926000252,safer,0,6,6
50f5eba5fdc9f065f00083cd,51422777fdc9f04926008677,safer,6,0,6
50f46447fdc9f065f00044ce,5140c8d6fdc9f04926002369,livelier,5,1,6
513d7a4efdc9f035870067a6,51414d17fdc9f049260074cb,more boring,5,1,6
513d7a5cfdc9f035870067de,513e1ce1fdc9f03587009860,more depressing,6,0,6
513cd128fdc9f03587001e29,5141502ffdc9f04926007ca4,wealthier,0,6,6
513d3660fdc9f03587002b93,513d67e7fdc9f035870041bf,more beautiful,6,0,6
513d36defdc9f03587002bc4,51414123fdc9f0492600616a,safer,2,4,6
50f43480fdc9f065f00028d1,513d32d0fdc9f035870028fe,more boring,0,6,6
50f43475fdc9f065f00027f4,513e203efdc9f0358700a156,livelier,4,2,6
50f563ccfdc9f065f0005e53,514133c9fdc9f04926004417,more depressing,1,5,6
50f563ccfdc9f065f0005e59,513e647cfdc9f0358700b82f,safer,0,6,6
50f5e6fbfdc9f065f0006e6e,513d2d3afdc9f035870024b5,livelier,1,5,6
513e21f4fdc9f0358700a4d5,5140985dfdc9f04926000c8d,safer,6,0,6
513e21d3fdc9f0358700a4ab,5140db8afdc9f04926003efd,livelier,6,0,6
513d68a5fdc9f0358700444d,513d7b4efdc9f03587006b04,livelier,1,5,6
50f60c46beb2fed9100001e2,513e6282fdc9f0358700b6e2,safer,1,5,6
50f61674beb2fed9100008a4,513d7a56fdc9f035870067c6,safer,6,0,6
50f61675beb2fed9100008b9,513d6876fdc9f0358700439f,livelier,6,0,6
50f60e73beb2fed910000661,513d7bf8fdc9f03587006d35,more boring,1,5,6
50f44505fdc9f065f00033b3,513d9c71fdc9f03587007d3c,more boring,0,6,6
50f5e691fdc9f065f0006d89,513e64fdfdc9f0358700b8e7,safer,0,6,6
50f55e38fdc9f065f0004b8b,50f5e895fdc9f065f000738d,safer,0,6,6
50f5e702fdc9f065f0006f28,513d3084fdc9f03587002733,safer,0,6,6
513d9c39fdc9f03587007c7d,51414f5ffdc9f04926007a99,more beautiful,6,0,6
513d9c1cfdc9f03587007c20,513f294afdc9f0358700d333,livelier,1,5,6
513d9b3cfdc9f03587007945,5140c8adfdc9f049260022e4,safer,0,6,6
50f5e6cafdc9f065f0006e4e,51422b83fdc9f04926008a4f,wealthier,0,6,6
513d2ed4fdc9f035870025e9,513d5ea5fdc9f03587003abe,more depressing,0,6,6
513d2f12fdc9f03587002613,514146defdc9f049260068ff,more boring,4,2,6
513d2f26fdc9f03587002622,513d7af3fdc9f035870069d4,livelier,6,0,6
513ce6ebfdc9f03587002287,513e6bfcfdc9f0358700c0d6,wealthier,5,1,6
5140b727fdc9f0492600190f,51422a08fdc9f049260088ce,safer,5,1,6
5140b76dfdc9f049260019d2,5185d49afdc9f03fd50013fe,more depressing,1,5,6
513d30cdfdc9f0358700276d,513d6a39fdc9f035870049d1,safer,6,0,6
513f2d24fdc9f0358700d9ac,5140d902fdc9f04926003b0f,safer,0,6,6
50f561f4fdc9f065f00057c9,513d6904fdc9f03587004598,livelier,5,1,6
50f56254fdc9f065f00058fe,51414728fdc9f049260069ba,more beautiful,6,0,6
50f5625bfdc9f065f000597c,513e1c62fdc9f03587009719,safer,4,2,6
513e1c35fdc9f035870096a1,5140d33bfdc9f04926003399,safer,5,1,6
513d3339fdc9f03587002944,513d9faafdc9f035870087bd,more boring,0,6,6
513d345afdc9f03587002a13,513d77d1fdc9f03587005f6e,more beautiful,6,0,6
51409ce5fdc9f0492600124f,5141484ffdc9f04926006c71,more depressing,0,6,6
50e5faecd7c3df413b00075c,50f56202fdc9f065f000584f,more boring,5,0,5
50f42b7dfdc9f065f00013f3,5140ccabfdc9f04926002e62,livelier,3,2,5
50f42b7efdc9f065f0001416,513d9f18fdc9f03587008622,safer,3,2,5
50f42b80fdc9f065f0001433,50f5619ffdc9f065f00055dd,livelier,4,1,5
50f42b80fdc9f065f0001443,5140d674fdc9f04926003665,more boring,0,5,5
50f42b82fdc9f065f0001459,50f46485fdc9f065f00046c5,safer,0,5,5
50f42b7cfdc9f065f00013ca,513e5f25fdc9f0358700b1d1,livelier,5,0,5
513d3652fdc9f03587002b88,513e1bcefdc9f0358700957d,safer,0,5,5
513ccfdefdc9f03587001de8,513d9d33fdc9f03587007fbc,safer,5,0,5
513cc847fdc9f03587001b0e,513f2be6fdc9f0358700d79c,livelier,0,5,5
513cc89afdc9f03587001b58,5140cc09fdc9f04926002cd8,livelier,3,2,5
513d51e2fdc9f03587002eda,5140d769fdc9f049260037e0,livelier,0,5,5
513d4c48fdc9f03587002e28,5185ce05fdc9f03fd5000dc3,safer,5,0,5
50f433dbfdc9f065f00027e5,51413387fdc9f0492600432c,livelier,1,4,5
51409c97fdc9f049260011f4,514133ddfdc9f0492600445d,safer,5,0,5
50f563d0fdc9f065f0005ec1,513e22c0fdc9f0358700a5c1,more depressing,2,3,5
51409ac2fdc9f04926000fab,5140ca55fdc9f049260027e4,safer,0,5,5
50f4347cfdc9f065f0002872,513d7d61fdc9f035870071ae,safer,5,0,5
50f433d5fdc9f065f0002757,513d2cf2fdc9f0358700247c,safer,0,5,5
50f4348cfdc9f065f000294f,50f44807fdc9f065f0003c99,safer,5,0,5
50f433dafdc9f065f00027ce,5140d2a9fdc9f0492600330f,livelier,0,5,5
50f433d4fdc9f065f000274e,51414f08fdc9f049260079c1,livelier,5,0,5
513d3659fdc9f03587002b8d,5141380cfdc9f04926005126,livelier,1,4,5
513e1d93fdc9f03587009a2f,51408ab0fdc9f0358700e792,more boring,1,4,5
50f5612ffdc9f065f0005535,5185cef6fdc9f03fd5000eac,safer,5,0,5
50f5612dfdc9f065f00054e1,51415157fdc9f04926007f7c,more boring,0,5,5
50f563b3fdc9f065f0005dbb,5140cbebfdc9f04926002c98,livelier,3,2,5
513da052fdc9f0358700894e,5140b66afdc9f049260016ee,wealthier,5,0,5
513da054fdc9f03587008957,513f2c49fdc9f0358700d843,safer,0,5,5
513da087fdc9f035870089c3,513e6cdcfdc9f0358700c202,safer,4,1,5
50f562e2fdc9f065f0005b3f,513cb2b3fdc9f03587000699,safer,0,5,5
51413bd4fdc9f04926005a5e,5185d249fdc9f03fd50011b5,safer,0,5,5
513cc68cfdc9f0358700196d,513f2d8dfdc9f0358700da6b,safer,0,5,5
513cc5f0fdc9f035870018df,513f14adfdc9f0358700cca2,livelier,5,0,5
50f5611ffdc9f065f000542b,513d7907fdc9f03587006382,livelier,0,5,5
513e1d29fdc9f0358700991c,513f1367fdc9f0358700cadc,livelier,0,5,5
513e1d7cfdc9f035870099fa,5140cad7fdc9f04926002975,safer,5,0,5
50f56122fdc9f065f0005457,5140b7a2fdc9f04926001a66,more beautiful,1,4,5
50f56122fdc9f065f000545c,513f2d73fdc9f0358700da3d,safer,2,3,5
50f5ebaefdc9f065f0008485,513d67ddfdc9f035870041a8,more beautiful,1,4,5
50f5eba7fdc9f065f0008402,51414adcfdc9f04926006ff2,more depressing,0,5,5
513d7924fdc9f035870063e3,513d7f25fdc9f03587007561,livelier,4,1,5
513d792bfdc9f035870063f8,5140cbd5fdc9f04926002c69,more boring,1,4,5
513d7943fdc9f03587006448,513d9c32fdc9f03587007c65,safer,0,5,5
5140d9d8fdc9f04926003cc6,5140dba8fdc9f04926003f1a,livelier,0,5,5
513d799cfdc9f03587006567,513d9f41fdc9f035870086a6,more boring,5,0,5
50f42c1bfdc9f065f00018d4,51409bd8fdc9f0492600110a,livelier,5,0,5
50f448adfdc9f065f0004180,5140d9bbfdc9f04926003c81,more beautiful,0,5,5
50f44869fdc9f065f0004085,51409bc0fdc9f049260010f0,wealthier,0,5,5
50f448a4fdc9f065f00040aa,5141421efdc9f0492600626e,livelier,1,4,5
50f44869fdc9f065f0004064,5140d804fdc9f04926003920,safer,4,1,5
50f448a8fdc9f065f0004116,50f5eac6fdc9f065f0007cb1,safer,0,5,5
50f5ebd3fdc9f065f0008604,513d5c36fdc9f03587003694,livelier,0,5,5
50f5ebd3fdc9f065f0008606,51409492fdc9f049260008b6,more boring,1,4,5
50f5eba7fdc9f065f00083fd,513d9b09fdc9f035870078a7,livelier,3,2,5
50f5eb46fdc9f065f0008180,513cc796fdc9f03587001a6a,wealthier,4,1,5
50f5eb63fdc9f065f0008255,513e1a3bfdc9f0358700915c,safer,0,5,5
50f5eb64fdc9f065f0008264,513e6198fdc9f0358700b586,safer,4,1,5
513d7abdfdc9f0358700692e,513d9d72fdc9f0358700808f,safer,1,4,5
50f5eb24fdc9f065f0008050,513d6abcfdc9f03587004b40,safer,4,1,5
50f5eb1ffdc9f065f0007feb,513d7b41fdc9f03587006ad7,safer,5,0,5
50f5eb20fdc9f065f0008000,513cc55efdc9f0358700185c,livelier,0,5,5
50f5eb3dfdc9f065f00080d0,513f1259fdc9f0358700c967,wealthier,0,5,5
50f5eb43fdc9f065f0008143,513e6d80fdc9f0358700c2dc,safer,2,3,5
50f46442fdc9f065f0004478,51422c98fdc9f04926008b4c,more depressing,5,0,5
50f46443fdc9f065f0004488,5141355dfdc9f049260049ab,safer,5,0,5
513e5fdefdc9f0358700b2e2,514091c4fdc9f04926000597,livelier,0,5,5
513e6006fdc9f0358700b320,51409b48fdc9f0492600105a,more beautiful,5,0,5
513e602dfdc9f0358700b35e,514145f1fdc9f049260066cd,safer,5,0,5
513e5f71fdc9f0358700b23f,5140da30fdc9f04926003d7d,safer,0,5,5
50f5eb4cfdc9f065f00081e9,51413fc5fdc9f0492600600b,livelier,5,0,5
50f5ec1dfdc9f065f0008780,50f60e70beb2fed91000062c,safer,0,5,5
513d78dcfdc9f035870062f0,513e6ec6fdc9f0358700c49e,livelier,0,5,5
50f448aafdc9f065f0004145,513d7c8efdc9f03587006f2f,wealthier,5,0,5
513e6426fdc9f0358700b7b9,51414634fdc9f0492600676a,livelier,0,5,5
513e646bfdc9f0358700b81b,5140cc97fdc9f04926002e33,more boring,4,1,5
50f5ed52fdc9f065f0008bc9,513cbf68fdc9f0358700128b,livelier,5,0,5
513e6d39fdc9f0358700c27b,5141340cfdc9f049260044fe,more boring,5,0,5
513e6d4cfdc9f0358700c299,51409b96fdc9f049260010be,more boring,2,3,5
50f5eceffdc9f065f0008b18,513d9ce7fdc9f03587007ed2,livelier,4,1,5
513d7849fdc9f035870060f7,5140c963fdc9f04926002503,more depressing,0,5,5
513d78c8fdc9f035870062a3,513e5d42fdc9f0358700ad45,more beautiful,0,5,5
513d7879fdc9f03587006195,51414620fdc9f04926006737,safer,5,0,5
50f5ec36fdc9f065f00087f5,5140b70dfdc9f049260018c5,safer,5,0,5
50f5ec1bfdc9f065f0008753,5141467bfdc9f04926006810,wealthier,4,1,5
513d78c5fdc9f0358700629c,51413914fdc9f04926005396,safer,0,5,5
50f5ec3afdc9f065f000883e,513e1fe3fdc9f0358700a05d,wealthier,0,5,5
513d7bb4fdc9f03587006c5d,513e1d02fdc9f035870098b8,safer,4,1,5
513d7bf4fdc9f03587006d2a,5140b8affdc9f04926001cce,wealthier,5,0,5
50f5eaf2fdc9f065f0007e9c,5140ba3bfdc9f04926001f90,safer,5,0,5
513e5d55fdc9f0358700ad7c,51409208fdc9f0492600061f,more boring,0,5,5
513e6556fdc9f0358700b959,514090e6fdc9f049260003c9,more depressing,1,4,5
513e658efdc9f0358700b9a8,513f11d3fdc9f0358700c8b0,safer,5,0,5
513e6c6cfdc9f0358700c176,51408c2afdc9f0358700ea90,more beautiful,5,0,5
513e6caafdc9f0358700c1c4,5185d44ffdc9f03fd50013b4,wealthier,5,0,5
50f42c12fdc9f065f0001811,50f448a6fdc9f065f00040eb,livelier,0,5,5
50f5eaf4fdc9f065f0007ed4,513cc9eafdc9f03587001c90,livelier,1,4,5
50f42eabfdc9f065f00022e0,50f5e870fdc9f065f00072a6,livelier,5,0,5
513e5f1cfdc9f0358700b1c5,51414670fdc9f049260067f9,more beautiful,0,5,5
50f42eaefdc9f065f0002328,513d9c42fdc9f03587007c98,livelier,5,0,5
5140c90ffdc9f04926002414,514137fdfdc9f04926005105,safer,0,5,5
50f42eaefdc9f065f0002329,50f563fefdc9f065f0005fca,more beautiful,2,3,5
50f42eb2fdc9f065f000237b,50f5e8fffdc9f065f00075fa,more boring,0,5,5
50f5eeadfdc9f065f0008fcc,513e1bcffdc9f0358700957f,more beautiful,5,0,5
513d6beafdc9f03587004e33,513d6cc5fdc9f0358700503e,livelier,5,0,5
513d6bcefdc9f03587004dea,513d9dbbfdc9f03587008195,safer,0,5,5
50f5ed69fdc9f065f0008d36,50f61674beb2fed9100008a7,safer,1,4,5
50f5ed9cfdc9f065f0008e5c,5140b903fdc9f04926001d6f,safer,0,5,5
50f5ed95fdc9f065f0008db7,51421c97fdc9f04926008597,livelier,5,0,5
50f5ee95fdc9f065f0008ec2,51413cf0fdc9f04926005c20,livelier,5,0,5
513d6d21fdc9f035870050d6,513d6d70fdc9f03587005155,livelier,5,0,5
50f42c45fdc9f065f00019cf,513d2eccfdc9f035870025e2,wealthier,5,0,5
50f42c52fdc9f065f0001aa8,50f5ebc7fdc9f065f00084fd,livelier,0,5,5
5140d8bbfdc9f04926003a90,514139d0fdc9f0492600555f,wealthier,0,5,5
50f4649afdc9f065f000489c,513cbe73fdc9f035870011a0,more depressing,3,2,5
513e6e88fdc9f0358700c44f,5140b80ffdc9f04926001b7c,safer,0,5,5
513f10d7fdc9f0358700c76a,51413ad1fdc9f049260057df,livelier,1,4,5
50f44811fdc9f065f0003d51,50f5eceefdc9f065f0008b00,wealthier,1,4,5
50f5eeaffdc9f065f0008ff3,51414b96fdc9f0492600710b,safer,0,5,5
50f4644dfdc9f065f0004555,513d9cf1fdc9f03587007ef1,safer,3,2,5
513e5dfbfdc9f0358700af43,5140da51fdc9f04926003dac,safer,5,0,5
513d7ce8fdc9f0358700704d,51415193fdc9f04926007fbe,wealthier,0,5,5
513d7cf3fdc9f03587007071,5140d843fdc9f0492600399a,livelier,1,4,5
50f5eaacfdc9f065f0007bf5,514139f2fdc9f049260055b2,safer,0,5,5
513d7ce3fdc9f0358700703b,5140b86efdc9f04926001c48,wealthier,0,5,5
50f5eac6fdc9f065f0007ca7,513f2a0afdc9f0358700d48a,safer,1,4,5
50f5e8e3fdc9f065f00075a0,5140d5a9fdc9f04926003525,more beautiful,5,0,5
50f44866fdc9f065f0003fb6,50f5eee5fdc9f065f0009056,more boring,5,0,5
50f44854fdc9f065f0003e55,5140b8defdc9f04926001d30,more boring,4,1,5
50f44853fdc9f065f0003e3b,513d9c28fdc9f03587007c41,more depressing,0,5,5
50f5ed59fdc9f065f0008c73,513f2ccefdc9f0358700d924,livelier,5,0,5
513d6e79fdc9f035870052f6,513d7bbafdc9f03587006c74,safer,5,0,5
513d7820fdc9f03587006069,5140b64afdc9f04926001693,safer,0,5,5
513e6509fdc9f0358700b8f7,513f14a8fdc9f0358700cc9b,wealthier,0,5,5
513e5d58fdc9f0358700ad83,51421c78fdc9f04926008574,safer,0,5,5
513d7e8ffdc9f03587007423,51414109fdc9f04926006150,livelier,4,1,5
50f5e880fdc9f065f000736b,513d9e46fdc9f03587008367,safer,5,0,5
50f42eaefdc9f065f0002304,50f5e55dfdc9f065f000675b,more boring,5,0,5
50f447d9fdc9f065f0003b11,5140cab8fdc9f04926002916,more depressing,5,0,5
513f1408fdc9f0358700cbb8,51413d71fdc9f04926005d38,wealthier,0,5,5
50f447dafdc9f065f0003b5d,50f5ed5afdc9f065f0008c9c,more boring,5,0,5
50f60b88beb2fed91000000e,513d6c44fdc9f03587004f16,livelier,3,2,5
513d6a71fdc9f03587004a7c,513d7b5efdc9f03587006b3e,wealthier,0,5,5
50f60122beb2fed6f80001ca,50f60b93beb2fed9100000c1,safer,0,5,5
513e6e1afdc9f0358700c3bc,513f2c9efdc9f0358700d8d5,livelier,5,0,5
513e5ce5fdc9f0358700ac40,513f2ff3fdc9f0358700de6e,wealthier,1,4,5
5140d91cfdc9f04926003b3d,514147f2fdc9f04926006b97,safer,0,5,5
5140d951fdc9f04926003bab,5185cf6efdc9f03fd5000f21,more boring,5,0,5
50f5eaa8fdc9f065f0007baf,51413993fdc9f049260054d2,more boring,0,5,5
513d7d3ffdc9f0358700715e,513e5f1ffdc9f0358700b1c9,livelier,0,5,5
50f5e8cdfdc9f065f0007522,513d7888fdc9f035870061c7,safer,4,1,5
514133a3fdc9f04926004397,51414efffdc9f049260079a9,more depressing,0,5,5
50f5eee7fdc9f065f0009097,513d9d1efdc9f03587007f7b,livelier,3,2,5
513d6b8ffdc9f03587004d52,5140d7c2fdc9f04926003896,safer,5,0,5
513d6b3afdc9f03587004c88,513e6e84fdc9f0358700c44a,more beautiful,5,0,5
50f42bb1fdc9f065f0001600,513e5f0afdc9f0358700b1aa,wealthier,0,5,5
50f6011fbeb2fed6f8000194,51413356fdc9f0492600427b,more depressing,5,0,5
50f5eee8fdc9f065f00090ad,513e602bfdc9f0358700b35b,more boring,0,5,5
50f5eee7fdc9f065f0009092,50f60c48beb2fed91000020f,safer,5,0,5
50f5ed59fdc9f065f0008c76,513f13b1fdc9f0358700cb43,livelier,5,0,5
50f5ecf4fdc9f065f0008b92,513f115cfdc9f0358700c813,more depressing,0,5,5
5140dba8fdc9f04926003f1a,51413aaafdc9f0492600577e,safer,0,5,5
513f11e0fdc9f0358700c8be,51413341fdc9f04926004239,safer,4,1,5
50f42eb3fdc9f065f00023be,50f5644afdc9f065f00061f5,more depressing,5,0,5
50f42eedfdc9f065f00023e2,513d9b8cfdc9f03587007a4a,more boring,5,0,5
50f42eb3fdc9f065f00023a4,513e1af1fdc9f03587009331,livelier,5,0,5
50f42bb1fdc9f065f0001607,513d9dc9fdc9f035870081c0,more boring,0,5,5
513d690afdc9f035870045ae,513e20d8fdc9f0358700a2f0,livelier,5,0,5
513d6954fdc9f035870046b9,5185cc09fdc9f03fd5000bcc,safer,1,4,5
50f60b89beb2fed91000001c,51392504818ede1296001017,more beautiful,0,5,5
50f60868beb2fed6f8000412,5140ca0afdc9f049260026f2,more beautiful,5,0,5
50f42efbfdc9f065f000247c,50f5eb3dfdc9f065f00080db,livelier,5,0,5
50f44562fdc9f065f0003478,51408915fdc9f0358700e436,livelier,4,1,5
513f2a0afdc9f0358700d48a,514094f3fdc9f04926000918,more depressing,0,5,5
50f445a8fdc9f065f0003543,50f5e70afdc9f065f0006fea,more beautiful,5,0,5
50f55e6cfdc9f065f0004c4d,50f5642efdc9f065f0006126,safer,4,1,5
513e210cfdc9f0358700a37a,51413dacfdc9f04926005db8,wealthier,5,0,5
50f60c4ebeb2fed9100002a0,513e6c90fdc9f0358700c1a6,livelier,1,4,5
513f2979fdc9f0358700d390,514133abfdc9f049260043af,livelier,5,0,5
513f28e4fdc9f0358700d289,5141346efdc9f04926004661,safer,5,0,5
50f445aafdc9f065f0003559,50f61683beb2fed910000986,wealthier,0,5,5
513f2947fdc9f0358700d330,5140cad6fdc9f04926002970,livelier,0,5,5
513d68f7fdc9f0358700456e,513e62ddfdc9f0358700b768,more depressing,0,5,5
513e2388fdc9f0358700a6a7,5140d30ffdc9f04926003371,more boring,3,2,5
50f46499fdc9f065f000485c,513cc5ccfdc9f035870018c3,more depressing,0,5,5
50f46498fdc9f065f0004815,513d77effdc9f03587005fcc,safer,0,5,5
50f5e897fdc9f065f00073b5,51413bedfdc9f04926005a7e,wealthier,4,1,5
513d8005fdc9f03587007683,513e5fbefdc9f0358700b2b4,wealthier,4,1,5
513d9b27fdc9f03587007901,51414851fdc9f04926006c7a,more boring,5,0,5
513d9af9fdc9f03587007871,514227bffdc9f049260086bd,safer,5,0,5
50f5e75efdc9f065f00070a1,513d67c5fdc9f03587004169,safer,4,1,5
513d6a47fdc9f03587004a01,513e1b1efdc9f035870093aa,wealthier,5,0,5
50f607d5beb2fed6f80002c5,5140da3efdc9f04926003d92,more beautiful,0,5,5
50f607d9beb2fed6f800030d,513d68cdfdc9f035870044d9,safer,0,5,5
50f607cfbeb2fed6f800024c,51409d77fdc9f049260012ff,livelier,0,5,5
50f607e4beb2fed6f80003d0,5140cf9afdc9f04926003162,more beautiful,0,5,5
50f607dabeb2fed6f8000323,513d6a0cfdc9f03587004932,safer,4,1,5
50f42c11fdc9f065f00017fd,513d9e94fdc9f0358700845f,more boring,5,0,5
50f55e35fdc9f065f0004b3f,51422c55fdc9f04926008b10,safer,4,1,5
50f55e6ffdc9f065f0004ca0,5141501cfdc9f04926007c77,safer,5,0,5
50f43babfdc9f065f00032ea,50f561fafdc9f065f0005800,more beautiful,2,3,5
50f44502fdc9f065f0003374,513e5df3fdc9f0358700af2d,livelier,0,5,5
513f2d83fdc9f0358700da5d,5140ce32fdc9f04926003013,wealthier,5,0,5
513f2ca7fdc9f0358700d8e3,5185cc65fdc9f03fd5000c22,more beautiful,4,1,5
513f2e38fdc9f0358700db90,51409806fdc9f04926000c19,more beautiful,0,5,5
513d60adfdc9f03587003d59,513e1ffbfdc9f0358700a0a6,livelier,5,0,5
51392cae818ede1296001227,513d9ee4fdc9f0358700856d,livelier,5,0,5
50f5e760fdc9f065f00070a9,51414e62fdc9f04926007829,livelier,2,3,5
513d9b54fdc9f035870079a2,513e64d4fdc9f0358700b8ad,safer,4,1,5
50f5e6cafdc9f065f0006e49,51392c1e818ede12960011fe,more beautiful,0,5,5
50f5e6fefdc9f065f0006eb7,50f5eb21fdc9f065f000801b,wealthier,2,3,5
513d9c5bfdc9f03587007cea,5141350afdc9f04926004897,more beautiful,0,5,5
513d9c6cfdc9f03587007d2a,513e1c73fdc9f03587009741,safer,4,1,5
513d9c7bfdc9f03587007d61,5140d510fdc9f0492600341d,safer,5,0,5
50f5e6c3fdc9f065f0006dae,51408baffdc9f0358700e9a1,wealthier,5,0,5
513d687dfdc9f035870043bb,5140da48fdc9f04926003da5,safer,2,3,5
513d688efdc9f035870043f6,51413fc7fdc9f0492600600e,safer,5,0,5
513d686cfdc9f03587004378,51408966fdc9f0358700e4e9,more beautiful,2,3,5
513d68a3fdc9f03587004447,5141418efdc9f049260061d7,safer,4,1,5
513e2110fdc9f0358700a388,51413daafdc9f04926005db7,safer,5,0,5
513e2249fdc9f0358700a533,513f2a9dfdc9f0358700d57c,livelier,1,4,5
513e2180fdc9f0358700a44e,5140b836fdc9f04926001bce,safer,0,5,5
50f55e08fdc9f065f00049f3,50f5eb6cfdc9f065f000830b,more depressing,0,5,5
513f2c0cfdc9f0358700d7e1,5185d397fdc9f03fd50012f3,safer,0,5,5
513f2c73fdc9f0358700d88c,51414ed3fdc9f0492600793a,more boring,4,1,5
50f61463beb2fed9100007af,5140b77ffdc9f04926001a02,safer,5,0,5
513d6849fdc9f03587004302,513d6a92fdc9f03587004acf,livelier,1,4,5
50f60c55beb2fed910000313,5140b674fdc9f04926001709,safer,1,4,5
50f60e72beb2fed910000649,513d680efdc9f03587004234,more depressing,1,4,5
50f61459beb2fed91000070a,514150f7fdc9f04926007e97,more boring,5,0,5
50f6145abeb2fed910000717,5140908efdc9f0492600030b,more depressing,0,5,5
513cb7b6fdc9f03587000b5d,513f2eb0fdc9f0358700dc67,safer,5,0,5
513d5f19fdc9f03587003b55,513d7a98fdc9f035870068b5,more boring,1,4,5
513cb306fdc9f035870006e8,513f2de4fdc9f0358700db03,livelier,0,5,5
513cb318fdc9f035870006fd,514090bcfdc9f04926000370,safer,5,0,5
513cb588fdc9f03587000951,514147b6fdc9f04926006afd,more depressing,5,0,5
513cb5b7fdc9f0358700097b,513f2ddffdc9f0358700dafa,wealthier,5,0,5
513f322efdc9f0358700e04c,51413fdefdc9f04926006023,livelier,0,5,5
50f43b74fdc9f065f0003104,514229b3fdc9f0492600888d,safer,0,5,5
50f43b90fdc9f065f0003218,50f5e872fdc9f065f00072db,safer,0,5,5
50f43baafdc9f065f00032ca,514133edfdc9f04926004494,more beautiful,5,0,5
50f43babfdc9f065f00032de,513cde80fdc9f035870020f1,more depressing,0,5,5
513f2f7bfdc9f0358700ddb2,5140b8cbfdc9f04926001d0e,safer,3,2,5
50f43b70fdc9f065f00030b9,513f2a8cfdc9f0358700d55e,livelier,0,5,5
513f30dafdc9f0358700df2d,5140c9b9fdc9f04926002601,more boring,5,0,5
513f3082fdc9f0358700dee4,51413b85fdc9f0492600599c,safer,0,5,5
513cb748fdc9f03587000afd,51414399fdc9f04926006407,safer,0,5,5
50f42c1dfdc9f065f0001956,513d5f0afdc9f03587003b44,livelier,1,4,5
5140d669fdc9f04926003657,5140d962fdc9f04926003bc6,livelier,5,0,5
50f5e646fdc9f065f0006bdd,5140901ffdc9f0492600021b,more boring,5,0,5
513d9cfcfdc9f03587007f10,51408c93fdc9f0358700eb5c,livelier,4,1,5
513d9d33fdc9f03587007fbe,5140b9cbfdc9f04926001f09,livelier,5,0,5
513d9d35fdc9f03587007fc3,51409e0ffdc9f049260013b9,more boring,5,0,5
513d5e67fdc9f03587003a6b,513d603cfdc9f03587003cc0,livelier,5,0,5
50f43ba4fdc9f065f0003266,513e1ae3fdc9f0358700930f,safer,5,0,5
513d61e1fdc9f03587003ed3,51414af8fdc9f04926007016,livelier,5,0,5
5139245c818ede1296000feb,5185cbb9fdc9f03fd5000b7d,safer,4,1,5
50f6167cbeb2fed910000914,513da138fdc9f03587008ab5,safer,5,0,5
513d61ebfdc9f03587003edf,513f148bfdc9f0358700cc71,safer,5,0,5
513d6823fdc9f03587004281,51409a34fdc9f04926000efa,safer,0,5,5
50f42c68fdc9f065f0001ba1,513d79bdfdc9f035870065c8,safer,0,5,5
5140ce62fdc9f0492600303d,5141452ffdc9f049260065aa,livelier,5,0,5
5140cfedfdc9f049260031b6,5185c34dfdc9f03fd5000a67,safer,0,5,5
513cbda8fdc9f035870010e0,513e60e0fdc9f0358700b477,safer,0,5,5
513cc0f0fdc9f03587001418,513d79c1fdc9f035870065d1,more boring,5,0,5
51408b40fdc9f0358700e8c1,5140db57fdc9f04926003ec5,livelier,4,1,5
50f43b6dfdc9f065f0003086,513cb8eafdc9f03587000c7f,safer,5,0,5
50f42efcfdc9f065f00024a2,50f5ed97fdc9f065f0008deb,more boring,5,0,5
51408b3afdc9f0358700e8b7,5140b6f4fdc9f0492600187b,wealthier,0,5,5
50f42efffdc9f065f000256b,513cbab0fdc9f03587000e19,more beautiful,0,5,5
513cbd2dfdc9f03587001068,5140c8e3fdc9f0492600238f,livelier,0,5,5
513d9dc6fdc9f035870081b9,513e6c5cfdc9f0358700c164,wealthier,1,4,5
513d9dd7fdc9f035870081ee,5140cd5afdc9f04926002f3a,livelier,1,4,5
50f5e566fdc9f065f0006847,5140c9cefdc9f04926002644,safer,4,1,5
50f5644ffdc9f065f000627f,51414ccefdc9f0492600740e,more boring,5,0,5
50f56450fdc9f065f0006291,513d79b7fdc9f035870065b5,more depressing,0,5,5
50f5e520fdc9f065f00066a7,513d7eaefdc9f0358700745f,wealthier,0,5,5
50f5e520fdc9f065f00066af,513d9b88fdc9f03587007a3e,more depressing,0,5,5
513e1f3dfdc9f03587009e93,51408c89fdc9f0358700eb49,livelier,4,1,5
50f42b82fdc9f065f000147d,50f42efcfdc9f065f00024c0,safer,0,5,5
513d5de0fdc9f03587003986,513f2a64fdc9f0358700d525,more boring,4,1,5
513d5e20fdc9f035870039f8,513d7a4efdc9f035870067a9,safer,0,5,5
513d5e32fdc9f03587003a1a,513d9a79fdc9f035870076d8,wealthier,0,5,5
50f5e5d2fdc9f065f0006a90,513cba5afdc9f03587000dd1,more depressing,0,5,5
50f5e582fdc9f065f0006935,513d7ca6fdc9f03587006f76,safer,5,0,5
513d9d69fdc9f03587008073,514145f9fdc9f049260066e1,safer,5,0,5
513d9d7efdc9f035870080bc,513e1b9efdc9f03587009506,safer,3,2,5
50f43b75fdc9f065f0003127,51409877fdc9f04926000cb5,safer,4,1,5
51408a7afdc9f0358700e728,5140b829fdc9f04926001bb2,safer,0,5,5
50f43aa8fdc9f065f0002ea6,50f5e87bfdc9f065f00072f0,wealthier,0,5,5
513cba3efdc9f03587000db7,51413460fdc9f0492600462d,more depressing,1,4,5
513cb974fdc9f03587000cfd,513e1beafdc9f035870095ce,safer,0,5,5
51413487fdc9f049260046ae,5142191ffdc9f049260081ec,livelier,5,0,5
514137c9fdc9f04926005052,51422798fdc9f0492600869a,livelier,3,2,5
514137d2fdc9f0492600507d,51421931fdc9f04926008200,safer,4,1,5
513d5aaffdc9f03587003425,5140cce8fdc9f04926002ecd,safer,5,0,5
513d5c4afdc9f035870036b9,5185d249fdc9f03fd50011b5,more boring,0,5,5
513cbfcefdc9f035870012f7,51408c42fdc9f0358700eabe,safer,0,5,5
513cbe70fdc9f0358700119f,5141351dfdc9f049260048ce,wealthier,0,5,5
50f4351afdc9f065f0002b0c,51409dc1fdc9f0492600135a,safer,3,2,5
50f4351bfdc9f065f0002b26,51408afdfdc9f0358700e83c,safer,0,5,5
514090befdc9f04926000378,51413c3bfdc9f04926005ae5,livelier,3,2,5
51409108fdc9f0492600040d,51413bbafdc9f04926005a1d,safer,5,0,5
513e1e89fdc9f03587009cbb,513f2de4fdc9f0358700db04,safer,5,0,5
50f43535fdc9f065f0002cd8,513d6a39fdc9f035870049ce,safer,5,0,5
50f439f0fdc9f065f0002d69,513e61c3fdc9f0358700b5ca,wealthier,0,5,5
513d57fefdc9f03587003271,5141409efdc9f049260060e1,livelier,0,5,5
513cc11afdc9f03587001447,513e6ad3fdc9f0358700bf57,livelier,5,0,5
513cc158fdc9f0358700147d,513d681dfdc9f03587004267,livelier,2,3,5
513cc290fdc9f035870015a6,51408f5cfdc9f049260000a2,livelier,0,5,5
513cc1f0fdc9f03587001507,51408c7efdc9f0358700eb35,safer,0,5,5
513d9df1fdc9f03587008246,51414cc9fdc9f04926007402,safer,1,4,5
50f5e528fdc9f065f0006706,51413a0dfdc9f049260055fa,more depressing,5,0,5
50f5e51efdc9f065f0006680,513f2fa9fdc9f0358700ddfd,safer,1,4,5
50f56410fdc9f065f00060ab,514147f1fdc9f04926006b94,safer,5,0,5
50f5644dfdc9f065f000624e,5140d7b8fdc9f0492600387e,wealthier,1,4,5
50f5644dfdc9f065f0006254,5141355ffdc9f049260049b0,wealthier,4,1,5
513e1e43fdc9f03587009bfb,5140c9befdc9f04926002615,safer,4,1,5
513e1e05fdc9f03587009b56,51413b91fdc9f049260059b8,safer,5,0,5
513cbc22fdc9f03587000f74,513d9f5ffdc9f03587008712,more depressing,3,2,5
513d5d56fdc9f03587003894,513f2cbffdc9f0358700d90d,wealthier,0,5,5
50f43b70fdc9f065f00030cf,513d7e6afdc9f035870073d2,wealthier,0,5,5
50f42c80fdc9f065f0001df9,50f5eba9fdc9f065f0008421,livelier,0,5,5
50f42c80fdc9f065f0001e02,50f5ed97fdc9f065f0008df3,more boring,1,4,5
50f42c7efdc9f065f0001d8e,513e1ec3fdc9f03587009d53,more beautiful,5,0,5
5140cae3fdc9f0492600299d,51413466fdc9f04926004641,safer,5,0,5
513d9ddafdc9f035870081f9,5141500efdc9f04926007c4e,safer,5,0,5
513e1d09fdc9f035870098cc,5140b727fdc9f04926001910,more beautiful,0,5,5
513d4c6cfdc9f03587002e2f,5185cccafdc9f03fd5000c88,safer,5,0,5
5140983cfdc9f04926000c66,5141444dfdc9f049260064b6,more beautiful,0,5,5
514093b9fdc9f049260007e9,5140ceb8fdc9f0492600308b,livelier,0,5,5
513d4f42fdc9f03587002e88,5141392afdc9f049260053cc,more depressing,5,0,5
51413b18fdc9f04926005895,51415024fdc9f04926007c89,more boring,5,0,5
514138edfdc9f04926005334,5185d529fdc9f03fd5001485,safer,0,5,5
513cc634fdc9f0358700191a,513cd2f6fdc9f03587001e7d,more boring,5,0,5
513d9f12fdc9f0358700860b,513f28e9fdc9f0358700d291,safer,1,4,5
50f42c53fdc9f065f0001af4,513e1e53fdc9f03587009c29,livelier,0,5,5
513d9f19fdc9f03587008628,5140d983fdc9f04926003c12,more boring,3,2,5
513d9f29fdc9f03587008659,513e626cfdc9f0358700b6bd,livelier,5,0,5
50f42c54fdc9f065f0001b33,513d9d38fdc9f03587007fcd,livelier,0,5,5
50f563f9fdc9f065f0005f54,513d697bfdc9f0358700474a,more beautiful,0,5,5
50f563d3fdc9f065f0005ef2,513d2ce3fdc9f03587002475,safer,0,5,5
50f563f9fdc9f065f0005f47,50f5ee93fdc9f065f0008e91,more depressing,5,0,5
513cc39efdc9f035870016b2,513d9c35fdc9f03587007c71,more boring,0,5,5
513cc3a8fdc9f035870016bf,51414529fdc9f049260065a1,livelier,5,0,5
513cc474fdc9f03587001781,5140d30ffdc9f04926003371,safer,0,5,5
5140b901fdc9f04926001d69,5140cac2fdc9f04926002930,more beautiful,0,5,5
513e1ea9fdc9f03587009d12,5140cad5fdc9f0492600296d,livelier,1,4,5
513e1ec7fdc9f03587009d5f,51408f12fdc9f04926000009,safer,5,0,5
50f560fafdc9f065f00053a4,50f5eb44fdc9f065f0008158,safer,0,5,5
513e1f03fdc9f03587009dff,513e1fd0fdc9f0358700a029,livelier,0,5,5
50f43525fdc9f065f0002ba2,50f5e87efdc9f065f0007338,safer,0,5,5
51409314fdc9f0492600073e,5140b67dfdc9f04926001728,livelier,0,5,5
50f43527fdc9f065f0002bc8,50f5e647fdc9f065f0006c0c,safer,0,5,5
513d5709fdc9f035870030c4,513e1ee3fdc9f03587009dad,safer,0,5,5
513d571dfdc9f035870030e5,513e1e96fdc9f03587009cdd,safer,5,0,5
513d5739fdc9f03587003119,513e23abfdc9f0358700a6d3,livelier,1,4,5
513cc386fdc9f0358700169a,514133ecfdc9f0492600448f,more depressing,0,5,5
513cc388fdc9f0358700169b,5140b686fdc9f0492600174c,safer,0,5,5
513e1ba5fdc9f03587009517,51408ac5fdc9f0358700e7c0,safer,5,0,5
50f5625ffdc9f065f000599d,51413c64fdc9f04926005b14,safer,5,0,5
513d31d4fdc9f03587002839,513d5073fdc9f03587002eaa,wealthier,5,0,5
50f42b50fdc9f065f00012cd,513e6106fdc9f0358700b4b3,safer,0,5,5
50f42b52fdc9f065f0001348,50f433cefdc9f065f00026bc,livelier,0,5,5
50f42b51fdc9f065f0001312,513cbeeefdc9f03587001213,safer,0,5,5
513d3180fdc9f035870027f9,513d79c6fdc9f035870065e8,more boring,0,5,5
50f433cefdc9f065f00026c7,50f607e1beb2fed6f8000388,more boring,5,0,5
50f56267fdc9f065f0005a0b,50f5e8a9fdc9f065f0007485,livelier,5,0,5
50f56268fdc9f065f0005a2f,513cb2fafdc9f035870006dc,more depressing,0,5,5
50f56267fdc9f065f0005a06,51409cb6fdc9f04926001218,more depressing,5,0,5
50f562dafdc9f065f0005ace,50f5e87efdc9f065f0007338,livelier,5,0,5
50f56269fdc9f065f0005a5f,51414608fdc9f049260066fe,livelier,5,0,5
50f56205fdc9f065f00058f2,513cba22fdc9f03587000d9d,safer,5,0,5
513e1bbcfdc9f03587009555,51413471fdc9f0492600466b,more beautiful,0,5,5
513e1bd2fdc9f0358700958a,51413982fdc9f049260054a6,livelier,4,1,5
50f561f2fdc9f065f00057a2,513e22edfdc9f0358700a5fc,wealthier,0,5,5
50f5619afdc9f065f00055c0,513d60c8fdc9f03587003d79,safer,0,5,5
513e1ca0fdc9f035870097b6,51414e9cfdc9f049260078bc,more beautiful,0,5,5
513e1cb5fdc9f035870097e6,51409013fdc9f04926000204,wealthier,0,5,5
50f56360fdc9f065f0005cd3,50f5ec38fdc9f065f0008817,wealthier,0,5,5
50f56364fdc9f065f0005d4d,51414d5afdc9f0492600757f,livelier,5,0,5
50f56361fdc9f065f0005cf9,50f5eac7fdc9f065f0007cc0,livelier,5,0,5
513e1a33fdc9f03587009144,51414408fdc9f04926006472,safer,5,0,5
50f433c2fdc9f065f0002625,50f5e640fdc9f065f0006bd3,livelier,5,0,5
50f433d1fdc9f065f0002709,513d9daefdc9f0358700816e,livelier,5,0,5
513cdbecfdc9f03587002061,5141507ffdc9f04926007d79,more depressing,2,3,5
513cdc0efdc9f0358700206b,513ce74bfdc9f0358700229c,livelier,0,5,5
513d34c8fdc9f03587002a66,513d78effdc9f03587006330,more depressing,4,1,5
513d34d4fdc9f03587002a6d,513d9fc6fdc9f03587008803,more depressing,3,2,5
513cdb98fdc9f0358700204e,51409e51fdc9f0492600140b,livelier,5,0,5
513cdf61fdc9f03587002125,5140cbf8fdc9f04926002cb6,safer,5,0,5
513e606dfdc9f0358700b3c1,5141341cfdc9f0492600452c,more boring,5,0,5
513e62b6fdc9f0358700b72d,51409e04fdc9f049260013ac,safer,5,0,5
513e6420fdc9f0358700b7af,5185d2bdfdc9f03fd5001225,more boring,0,5,5
50f42c09fdc9f065f0001752,51408934fdc9f0358700e480,more boring,0,5,5
513d7a49fdc9f03587006797,513e1bc9fdc9f03587009574,safer,5,0,5
50f42c0dfdc9f065f00017a8,5141359bfdc9f04926004a7d,more beautiful,4,1,5
50f5eb67fdc9f065f00082a0,513cb999fdc9f03587000d21,safer,4,1,5
50f5eb69fdc9f065f00082c5,513d7cdbfdc9f03587007027,more beautiful,0,5,5
513e1c82fdc9f0358700976a,51414d8afdc9f049260075fe,safer,5,0,5
51414d92fdc9f04926007612,5185cc88fdc9f03fd5000c42,more depressing,5,0,5
513d2cfafdc9f03587002482,513d7875fdc9f0358700618d,more boring,0,5,5
513d2d12fdc9f03587002493,51413c8cfdc9f04926005b47,safer,0,5,5
513d2f43fdc9f03587002638,51413ae2fdc9f04926005809,more boring,5,0,5
513d2f57fdc9f03587002643,5185d2c1fdc9f03fd500122a,livelier,0,5,5
513d3026fdc9f035870026e9,513d9ed8fdc9f0358700853f,livelier,0,5,5
513e60b4fdc9f0358700b42f,5140d733fdc9f04926003780,more beautiful,5,0,5
513d3426fdc9f035870029ec,5140b6cffdc9f0492600181d,safer,0,5,5
513ceb01fdc9f03587002358,51413a16fdc9f0492600560e,more beautiful,1,4,5
513d33d8fdc9f035870029b4,513e1ae7fdc9f0358700931b,safer,5,0,5
50f56258fdc9f065f0005936,5185cf00fdc9f03fd5000eb7,livelier,5,0,5
50f5625ffdc9f065f0005995,514141c9fdc9f04926006214,livelier,1,4,5
513e1c43fdc9f035870096c5,513e61a5fdc9f0358700b59e,wealthier,5,0,5
513e1c3ffdc9f035870096b7,514135b3fdc9f04926004adf,safer,1,4,5
50f561cbfdc9f065f000572d,513cec09fdc9f0358700238e,safer,4,1,5
5140b71bfdc9f049260018f0,514133fffdc9f049260044d2,safer,4,1,5
50e5f7d9d7c3df413b0005a8,50f5e51dfdc9f065f0006670,livelier,5,0,5
5140b775fdc9f049260019e4,5141347afdc9f0492600468a,more depressing,0,5,5
5140b7adfdc9f04926001a89,514226f1fdc9f049260085f5,livelier,5,0,5
51421849fdc9f0492600810d,51422d48fdc9f04926008bfc,livelier,0,5,5
51421c15fdc9f0492600850b,51421c65fdc9f0492600855c,more depressing,5,0,5
50f3981ffdc9f065f0000e0a,513d7d1efdc9f035870070f4,livelier,5,0,5
513ce719fdc9f0358700228c,5140b959fdc9f04926001e23,livelier,0,5,5
50e748e5d7c3df413b0013ef,513e6f6afdc9f0358700c580,livelier,4,0,4
51414be8fdc9f049260071d0,51422c7dfdc9f04926008b35,more boring,4,0,4
51414e18fdc9f04926007767,5185cde7fdc9f03fd5000daa,safer,4,0,4
513d2da2fdc9f03587002502,5141363ffdc9f04926004c17,more depressing,0,4,4
513d2cd6fdc9f03587002468,51414d41fdc9f04926007540,safer,0,4,4
50f561cbfdc9f065f0005722,513d7c1efdc9f03587006db7,livelier,0,4,4
50e748e4d7c3df413b0013cc,513d7906fdc9f0358700637b,more depressing,4,0,4
50f5625ffdc9f065f0005984,50f5eb62fdc9f065f0008236,safer,4,0,4
50f5625ffdc9f065f0005982,513d9ad9fdc9f03587007811,safer,4,0,4
50f56267fdc9f065f00059d8,50f5e87afdc9f065f00072e0,more boring,0,4,4
513d31f8fdc9f03587002856,513e1c30fdc9f03587009693,more beautiful,4,0,4
513cddb0fdc9f035870020c7,513d9aa1fdc9f0358700774d,safer,1,3,4
50e748e5d7c3df413b0013e3,5141408cfdc9f049260060d4,safer,4,0,4
513ce0bbfdc9f0358700216a,513d9e16fdc9f035870082be,livelier,0,4,4
513cdcb4fdc9f0358700208e,514099e3fdc9f04926000e91,more depressing,0,4,4
513cdceefdc9f03587002099,513d69ecfdc9f035870048cd,more depressing,0,4,4
51409dabfdc9f0492600133d,51422af0fdc9f049260089bf,safer,4,0,4
513d344efdc9f03587002a0a,51408f49fdc9f04926000072,safer,0,4,4
50f562e3fdc9f065f0005b80,513e5feffdc9f0358700b2fb,more depressing,0,4,4
513e1ac3fdc9f035870092c2,5185cb2efdc9f03fd5000af1,livelier,0,4,4
513e1a5bfdc9f035870091b2,5140cc77fdc9f04926002de0,wealthier,4,0,4
513e1a79fdc9f03587009202,51409ad2fdc9f04926000fc6,more beautiful,4,0,4
50f56364fdc9f065f0005d4b,5185cd8ffdc9f03fd5000d4e,safer,0,4,4
513d3385fdc9f03587002978,513d5e8efdc9f03587003aa2,more boring,4,0,4
513ceb3dfdc9f03587002362,51422ca1fdc9f04926008b58,more boring,4,0,4
51414f86fdc9f04926007af9,51422c62fdc9f04926008b1a,safer,0,4,4
513cecbdfdc9f035870023b5,513e5d82fdc9f0358700adfc,livelier,0,4,4
513ce75dfdc9f035870022a2,513d607cfdc9f03587003d15,safer,0,4,4
50f43464fdc9f065f00027f0,51422bcffdc9f04926008a90,safer,4,0,4
513d3453fdc9f03587002a0c,514218b9fdc9f04926008180,livelier,4,0,4
50f433d3fdc9f065f0002737,513cc290fdc9f035870015a8,wealthier,0,4,4
513d3642fdc9f03587002b7c,51414d29fdc9f049260074ff,more depressing,4,0,4
50f433d4fdc9f065f0002755,50f5eba3fdc9f065f00083b8,safer,3,1,4
50f4348efdc9f065f000296b,514134b3fdc9f04926004759,safer,4,0,4
50f43488fdc9f065f00028f5,50f55e9bfdc9f065f0004d92,safer,4,0,4
50f4347cfdc9f065f0002870,513e5ca4fdc9f0358700ab97,safer,4,0,4
51409b57fdc9f0492600106d,51414d89fdc9f049260075f9,safer,0,4,4
513cd9e2fdc9f03587001ff6,513e1ce8fdc9f03587009874,more depressing,4,0,4
513cd762fdc9f03587001f72,513d7902fdc9f0358700636b,more boring,0,4,4
513cd070fdc9f03587001dff,513e6b09fdc9f0358700bf9a,livelier,4,0,4
513d4ae8fdc9f03587002dfa,5140ce05fdc9f04926002fe6,safer,4,0,4
513cc8e8fdc9f03587001ba5,514226f1fdc9f049260085f6,wealthier,4,0,4
513ccb30fdc9f03587001cf5,5140b8cafdc9f04926001d0a,wealthier,4,0,4
513cc7d8fdc9f03587001aa4,514227d1fdc9f049260086ce,more beautiful,0,4,4
513cc840fdc9f03587001b07,513d69edfdc9f035870048d2,safer,4,0,4
513cc840fdc9f03587001b08,513e1a25fdc9f03587009123,livelier,4,0,4
50f563d0fdc9f065f0005ec4,5185cdc5fdc9f03fd5000d87,more beautiful,0,4,4
50f561befdc9f065f0005667,50f5ec1bfdc9f065f000875e,more depressing,4,0,4
50f562d4fdc9f065f0005a78,513e22a1fdc9f0358700a59b,safer,0,4,4
50f562e2fdc9f065f0005b33,51413b98fdc9f049260059c4,wealthier,0,4,4
513e1b19fdc9f0358700939d,513e6218fdc9f0358700b64a,livelier,0,4,4
513e1b6efdc9f03587009490,51409dadfdc9f04926001340,safer,4,0,4
50f562d9fdc9f065f0005ac5,5141471cfdc9f0492600699c,livelier,4,0,4
50f56268fdc9f065f0005a22,513d332efdc9f0358700293e,safer,4,0,4
50f56269fdc9f065f0005a4f,51409027fdc9f04926000231,safer,4,0,4
50f56268fdc9f065f0005a15,513ce07ffdc9f0358700215d,more depressing,4,0,4
513ccce8fdc9f03587001d5b,513d9f51fdc9f035870086df,livelier,4,0,4
513cccf2fdc9f03587001d5d,5140b6f5fdc9f0492600187e,safer,4,0,4
51409a70fdc9f04926000f4c,51413bd7fdc9f04926005a62,safer,4,0,4
513cccaefdc9f03587001d50,513d577afdc9f03587003188,safer,0,4,4
513cc940fdc9f03587001bf6,513ce13bfdc9f03587002185,wealthier,4,0,4
513cc978fdc9f03587001c2c,5141373dfdc9f04926004e4c,more depressing,0,4,4
513d5489fdc9f03587002f2a,513d7a95fdc9f035870068ac,safer,4,0,4
513d5590fdc9f03587002f53,5140d03afdc9f04926003205,more depressing,4,0,4
513d5665fdc9f03587002f9d,5140d68dfdc9f04926003681,safer,0,4,4
513d4f2dfdc9f03587002e84,513d7b32fdc9f03587006aa2,livelier,3,1,4
513d50d2fdc9f03587002eb8,513e6b0bfdc9f0358700bf9e,safer,0,4,4
513d510bfdc9f03587002ec1,513d7cd6fdc9f0358700701b,livelier,4,0,4
51409ab2fdc9f04926000f99,51422c7ffdc9f04926008b39,more beautiful,0,4,4
51409ab6fdc9f04926000f9c,51422debfdc9f04926008c90,safer,4,0,4
50f5640ffdc9f065f000607b,51409053fdc9f0492600028e,more boring,0,4,4
50f56121fdc9f065f0005448,513e1b8ffdc9f035870094e2,wealthier,0,4,4
50f5611ffdc9f065f000542f,50f5ed67fdc9f065f0008d07,livelier,4,0,4
513e1d65fdc9f035870099b7,5185d253fdc9f03fd50011c1,safer,0,4,4
513e1ce4fdc9f03587009869,514148e1fdc9f04926006d4c,livelier,0,4,4
513e1c87fdc9f03587009778,513f2be5fdc9f0358700d79b,safer,4,0,4
513e1cccfdc9f03587009821,514133c3fdc9f049260043fe,safer,0,4,4
50f5640efdc9f065f000606b,513d6d90fdc9f0358700518b,livelier,3,1,4
50f562e2fdc9f065f0005b22,50f5ed53fdc9f065f0008be7,more beautiful,0,4,4
50f562e2fdc9f065f0005b2c,51422d51fdc9f04926008c04,safer,0,4,4
513e1ce0fdc9f0358700985c,514134f0fdc9f04926004835,safer,0,4,4
50f561c5fdc9f065f00056dc,51409e95fdc9f04926001462,more beautiful,4,0,4
514093c3fdc9f049260007f4,5140d1bafdc9f04926003236,more depressing,3,1,4
513d4c90fdc9f03587002e32,513f1535fdc9f0358700cd5c,safer,3,1,4
50f43516fdc9f065f0002aec,513d5fe4fdc9f03587003c55,livelier,0,4,4
50f4349bfdc9f065f0002a4f,513e5d52fdc9f0358700ad74,more beautiful,1,3,4
51409520fdc9f0492600093f,51413baafdc9f049260059f4,more boring,4,0,4
51413810fdc9f04926005130,51413fe1fdc9f04926006029,more boring,0,4,4
513cc67cfdc9f0358700195c,513e1f87fdc9f03587009f5b,more boring,0,4,4
50f42b89fdc9f065f0001532,513d7c03fdc9f03587006d62,safer,4,0,4
51413b2ffdc9f049260058ca,514219b8fdc9f04926008283,livelier,0,4,4
513cc520fdc9f03587001825,513d3604fdc9f03587002b51,wealthier,0,4,4
50f42b89fdc9f065f0001542,513e1f81fdc9f03587009f4d,wealthier,0,4,4
50f42babfdc9f065f0001565,50f5eafafdc9f065f0007f42,safer,4,0,4
50f42b88fdc9f065f00014fc,514137a9fdc9f04926004fe2,more depressing,4,0,4
50f42b88fdc9f065f0001514,51413a5cfdc9f049260056bb,safer,0,4,4
50f42b88fdc9f065f00014e7,50f5eee5fdc9f065f0009057,livelier,3,1,4
50f42b88fdc9f065f00014e8,50f448b0fdc9f065f00041bd,livelier,4,0,4
513cc50efdc9f03587001813,514142abfdc9f049260062ff,livelier,0,4,4
513cc348fdc9f03587001659,51414d7ffdc9f049260075dd,livelier,4,0,4
51409137fdc9f04926000477,5141384efdc9f049260051bf,more beautiful,4,0,4
51408fa2fdc9f04926000123,5140d676fdc9f04926003666,livelier,4,0,4
513d56c9fdc9f03587003045,513e61e0fdc9f0358700b5f5,livelier,3,1,4
50f43526fdc9f065f0002bba,513d7cfafdc9f03587007085,safer,0,4,4
50f4351cfdc9f065f0002b4e,514138fbfdc9f04926005356,more beautiful,0,4,4
50f42c73fdc9f065f0001cd5,50f5e690fdc9f065f0006d67,safer,3,1,4
50f42c7dfdc9f065f0001d10,5140c9adfdc9f049260025df,safer,4,0,4
50f42c6efdc9f065f0001c4d,51414043fdc9f04926006093,livelier,4,0,4
513d9fecfdc9f03587008858,51413baefdc9f04926005a05,livelier,0,4,4
5140ccd6fdc9f04926002eb8,51414c5cfdc9f049260072fc,more depressing,3,1,4
513d9f0cfdc9f035870085f9,51422795fdc9f04926008697,safer,4,0,4
50f5612efdc9f065f0005503,513d3360fdc9f03587002961,safer,0,4,4
50f563d0fdc9f065f0005eab,50f5eaf3fdc9f065f0007ebe,livelier,4,0,4
50f563b1fdc9f065f0005d89,50f5644dfdc9f065f0006243,safer,0,4,4
50f563b1fdc9f065f0005d94,50f5ebd4fdc9f065f0008616,safer,0,4,4
50f563b3fdc9f065f0005db3,513d9fc3fdc9f035870087fb,safer,0,4,4
513e1cf3fdc9f0358700988f,513e1d71fdc9f035870099da,more beautiful,4,0,4
513d9f4ffdc9f035870086d5,513e1db3fdc9f03587009a7f,more beautiful,0,4,4
50f4351dfdc9f065f0002b69,5185d24dfdc9f03fd50011bb,safer,0,4,4
50f439f0fdc9f065f0002d6d,513d3121fdc9f035870027ae,more boring,4,0,4
51408fd1fdc9f04926000182,5140d7d6fdc9f049260038ba,safer,0,4,4
513d5673fdc9f03587002fb8,5185cae4fdc9f03fd5000ab0,livelier,4,0,4
513d5786fdc9f0358700319d,513d6b7ffdc9f03587004d2c,more beautiful,4,0,4
513d578bfdc9f035870031a4,514138bafdc9f049260052ba,more depressing,0,4,4
50f439f8fdc9f065f0002e0b,513d3086fdc9f03587002734,safer,0,4,4
50f43532fdc9f065f0002c9e,50f60866beb2fed6f80003e3,livelier,1,3,4
50f43532fdc9f065f0002cad,514134defdc9f049260047f7,safer,0,4,4
5140b961fdc9f04926001e37,514137ccfdc9f0492600505f,safer,4,0,4
5140b964fdc9f04926001e3b,514137f4fdc9f049260050ee,safer,4,0,4
513cbf4afdc9f0358700126a,513e1d02fdc9f035870098b7,more beautiful,0,4,4
513cc4bcfdc9f035870017bf,5140ca10fdc9f04926002706,livelier,0,4,4
50f43aadfdc9f065f0002efc,50f447dafdc9f065f0003b57,safer,4,0,4
50f43aaefdc9f065f0002f02,514134dbfdc9f049260047ed,livelier,1,3,4
513cbfaafdc9f035870012d5,5140c842fdc9f0492600219e,safer,0,4,4
513cbf42fdc9f03587001262,5140d056fdc9f04926003220,wealthier,0,4,4
513cc2e2fdc9f035870015f2,5140d8ebfdc9f04926003ae7,safer,0,4,4
513cbe70fdc9f0358700119e,513d32cdfdc9f035870028fb,more beautiful,3,1,4
50f56447fdc9f065f00061b5,513cb800fdc9f03587000ba0,livelier,4,0,4
50f560ecfdc9f065f00052f1,51409238fdc9f04926000672,safer,0,4,4
513e1e2ffdc9f03587009bca,514089fefdc9f0358700e633,livelier,4,0,4
50f42c54fdc9f065f0001b1f,513cc4aefdc9f035870017b4,safer,0,4,4
513e1d81fdc9f03587009a08,51421abffdc9f0492600839a,more depressing,0,4,4
50f56449fdc9f065f00061e3,513d5709fdc9f035870030c3,wealthier,0,4,4
50f56449fdc9f065f00061ec,50f5ed98fdc9f065f0008e12,safer,0,4,4
50f5640afdc9f065f0005ff9,513d9ec3fdc9f035870084f3,wealthier,4,0,4
50f42c54fdc9f065f0001b25,513cbb45fdc9f03587000ead,more depressing,0,4,4
50f42c53fdc9f065f0001b02,50f56099fdc9f065f000524e,livelier,0,4,4
513d58f4fdc9f03587003347,513e5d53fdc9f0358700ad77,safer,0,4,4
513d5c50fdc9f035870036c5,513d9eb9fdc9f035870084d4,safer,0,4,4
513d5b1afdc9f0358700349d,5140cdd6fdc9f04926002fb2,safer,4,0,4
513d5d70fdc9f035870038c2,513f2c4cfdc9f0358700d847,livelier,1,3,4
513cbc50fdc9f03587000fa3,514219c7fdc9f04926008292,safer,0,4,4
513d5d5dfdc9f035870038a2,513d6e0bfdc9f03587005250,safer,4,0,4
513d5d6efdc9f035870038be,514148e7fdc9f04926006d52,wealthier,4,0,4
513d5cbafdc9f03587003785,51422a5dfdc9f04926008929,livelier,0,4,4
513d5d08fdc9f03587003810,5185cd7dfdc9f03fd5000d37,wealthier,4,0,4
513d5c85fdc9f0358700372b,51415089fdc9f04926007d95,safer,0,4,4
50f43ab2fdc9f065f0002f6a,513e1bdcfdc9f035870095a8,wealthier,0,4,4
5140b884fdc9f04926001c75,51415076fdc9f04926007d5f,livelier,0,4,4
50f42f00fdc9f065f0002581,513d2dd9fdc9f03587002527,more boring,0,4,4
50f42f00fdc9f065f0002586,50f463c6fdc9f065f0004316,safer,4,0,4
50f42efffdc9f065f000257a,5140d8d6fdc9f04926003ac6,livelier,4,0,4
50f42efffdc9f065f000257b,5140c901fdc9f049260023ed,livelier,4,0,4
50f42efdfdc9f065f00024f5,50f563fcfdc9f065f0005fa4,more boring,0,4,4
51408b90fdc9f0358700e966,5140d9bbfdc9f04926003c81,more depressing,4,0,4
513f3251fdc9f0358700e067,5140c9e5fdc9f04926002693,more boring,3,1,4
513cb901fdc9f03587000c93,51421bebfdc9f049260084de,safer,0,4,4
513cb956fdc9f03587000cdf,5140b733fdc9f04926001934,livelier,0,4,4
51408995fdc9f0358700e543,51422c3dfdc9f04926008af6,livelier,4,0,4
5140899dfdc9f0358700e557,5140b68efdc9f0492600176a,safer,4,0,4
50f42c80fdc9f065f0001dd5,50f5e8e3fdc9f065f00075ac,safer,0,4,4
5140ca84fdc9f04926002878,51422cc1fdc9f04926008b77,more boring,3,1,4
50f560fbfdc9f065f00053dc,513e1bfafdc9f035870095fb,safer,0,4,4
513e1eddfdc9f03587009d9c,51415131fdc9f04926007f1a,livelier,0,4,4
50f5e400fdc9f065f0006618,513d6812fdc9f03587004242,livelier,4,0,4
50f5e51afdc9f065f0006634,5185cd85fdc9f03fd5000d40,safer,4,0,4
50f560f1fdc9f065f0005340,51413769fdc9f04926004ee4,safer,0,4,4
513d9ee9fdc9f0358700857f,51409207fdc9f0492600061e,livelier,1,3,4
513e1e1afdc9f03587009b90,51422834fdc9f04926008732,more beautiful,0,4,4
513cbc98fdc9f03587000fe7,51421bfafdc9f049260084ee,more boring,3,1,4
513f327ffdc9f0358700e094,5185cc17fdc9f03fd5000bda,more boring,1,3,4
50f43b78fdc9f065f0003173,5140d6f8fdc9f04926003709,safer,0,4,4
50f43b75fdc9f065f000312c,50f60866beb2fed6f80003e8,livelier,0,4,4
513d5db8fdc9f03587003945,5140b6eafdc9f0492600185e,livelier,3,1,4
513d5e5ffdc9f03587003a60,5140dbfdfdc9f04926003f6e,wealthier,3,1,4
513d5e11fdc9f035870039d8,514147e2fdc9f04926006b6d,more boring,0,4,4
50f42bbbfdc9f065f00016dc,50f5e648fdc9f065f0006c61,livelier,4,0,4
513cbaecfdc9f03587000e58,513e6c25fdc9f0358700c118,safer,0,4,4
50f42b82fdc9f065f000146a,513d7e5efdc9f035870073bc,safer,0,4,4
50f42b87fdc9f065f00014b4,51413c26fdc9f04926005ad0,safer,1,3,4
513d9d82fdc9f035870080cb,51413a7cfdc9f0492600570b,safer,0,4,4
513d9dbafdc9f03587008191,514228cafdc9f049260087c2,more boring,0,4,4
50f5e5d0fdc9f065f0006a6d,51421bb3fdc9f049260084a0,more boring,0,4,4
50f5e588fdc9f065f00069af,5141342dfdc9f0492600456a,safer,4,0,4
50f42dddfdc9f065f0002214,50f5644bfdc9f065f0006214,more depressing,0,4,4
513d9e4afdc9f03587008371,51408b3cfdc9f0358700e8b8,livelier,4,0,4
513e1fa8fdc9f03587009fb9,513e613ffdc9f0358700b504,safer,0,4,4
5140cb16fdc9f04926002a42,514143eafdc9f04926006458,safer,4,0,4
50f42dddfdc9f065f000221a,513e5d6dfdc9f0358700adbb,safer,3,1,4
51413588fdc9f04926004a3e,51415142fdc9f04926007f44,more depressing,0,4,4
513cb6f8fdc9f03587000ab3,5140cc94fdc9f04926002e2e,wealthier,4,0,4
513d5e7efdc9f03587003a8b,513d6ac1fdc9f03587004b50,livelier,0,4,4
50f42bbafdc9f065f000168d,51422762fdc9f04926008660,livelier,0,4,4
513cba4afdc9f03587000dc2,513e6581fdc9f0358700b993,wealthier,0,4,4
513cbaa6fdc9f03587000e11,514141a3fdc9f049260061ed,safer,1,3,4
513cb6c6fdc9f03587000a89,513e6d45fdc9f0358700c28d,safer,1,3,4
50f43b92fdc9f065f0003250,51414cf4fdc9f04926007474,livelier,4,0,4
513f30dafdc9f0358700df2d,5140da2afdc9f04926003d6f,safer,4,0,4
513f2f91fdc9f0358700ddd0,5185d522fdc9f03fd5001480,livelier,0,4,4
513f2e93fdc9f0358700dc37,5140d7cffdc9f049260038af,livelier,4,0,4
50f43baafdc9f065f00032cb,513d7e38fdc9f0358700736b,livelier,4,0,4
513cb322fdc9f03587000703,513e2035fdc9f0358700a13a,safer,4,0,4
50f43b93fdc9f065f000325c,50f56125fdc9f065f000548f,safer,4,0,4
50f43ba4fdc9f065f0003260,513e21fdfdc9f0358700a4dd,safer,1,3,4
50f43b8ffdc9f065f00031f8,5140d7b9fdc9f04926003880,safer,4,0,4
50f43b78fdc9f065f0003176,50f5e6cafdc9f065f0006e3d,more boring,4,0,4
50f43b8efdc9f065f00031db,513d2ffcfdc9f035870026c8,wealthier,0,4,4
513d604cfdc9f03587003cd8,513d61d7fdc9f03587003ec6,safer,4,0,4
513cb616fdc9f035870009e3,514092b9fdc9f049260006e6,more depressing,0,4,4
513cb5b9fdc9f0358700097e,514228b2fdc9f049260087a7,safer,0,4,4
513cb31efdc9f03587000700,513d9d3cfdc9f03587007fdb,more boring,4,0,4
513d5eb1fdc9f03587003ace,513d9c58fdc9f03587007ce1,more beautiful,4,0,4
513cb2eafdc9f035870006ce,5142276efdc9f0492600866a,safer,0,4,4
513cb2fafdc9f035870006db,513d6b8cfdc9f03587004d49,safer,4,0,4
513d6007fdc9f03587003c77,513d6976fdc9f03587004732,livelier,4,0,4
513d6009fdc9f03587003c7c,51415173fdc9f04926007fa1,safer,4,0,4
513d9cd2fdc9f03587007e84,5140c9b4fdc9f049260025f7,livelier,4,0,4
5140cbf8fdc9f04926002cb5,5140d905fdc9f04926003b13,safer,4,0,4
5140cc46fdc9f04926002d69,51414cccfdc9f04926007409,more beautiful,0,4,4
5140cb44fdc9f04926002ad9,5140dad2fdc9f04926003e33,more depressing,3,1,4
50f5e561fdc9f065f00067b5,513d6b69fdc9f03587004cf5,livelier,0,4,4
50f5e561fdc9f065f00067b6,513d68eefdc9f0358700454d,safer,0,4,4
50f5e569fdc9f065f00068a0,5185cf89fdc9f03fd5000f43,safer,4,0,4
50f5e56ffdc9f065f000692a,513e1b5dfdc9f03587009460,safer,4,0,4
513d9cfdfdc9f03587007f15,513e1fe5fdc9f0358700a065,safer,4,0,4
513d9d81fdc9f035870080ca,5142179bfdc9f0492600804d,livelier,4,0,4
513d9d57fdc9f03587008032,51409024fdc9f0492600022a,livelier,4,0,4
50f5e528fdc9f065f000672c,5140d8fcfdc9f04926003b07,more depressing,3,1,4
513cb746fdc9f03587000afc,51413358fdc9f04926004287,livelier,4,0,4
513d5fcbfdc9f03587003c3a,513d691bfdc9f035870045f2,more depressing,0,4,4
513d5f04fdc9f03587003b3c,513e1ae9fdc9f03587009321,more beautiful,3,1,4
513d5f09fdc9f03587003b41,513e1c97fdc9f035870097a2,more boring,0,4,4
513d5ea9fdc9f03587003ac3,513e1b2efdc9f035870093db,wealthier,4,0,4
513cb88afdc9f03587000c22,513f1084fdc9f0358700c6f8,livelier,0,4,4
513cb8eafdc9f03587000c7f,513d9d56fdc9f03587008031,more beautiful,4,0,4
513cb7d8fdc9f03587000b78,513cc24afdc9f0358700155f,livelier,0,4,4
513cb7dafdc9f03587000b79,513d7e5efdc9f035870073bb,more boring,3,1,4
51392e6a818ede129600129c,513f10a3fdc9f0358700c721,safer,0,4,4
50f43bb0fdc9f065f0003361,51409cdbfdc9f04926001243,livelier,4,0,4
51392a2c818ede1296001177,513e5fa0fdc9f0358700b285,wealthier,0,4,4
513f2df8fdc9f0358700db2c,5185cae9fdc9f03fd5000ab6,more beautiful,0,4,4
50f55e37fdc9f065f0004b67,513d3192fdc9f03587002807,wealthier,4,0,4
50f42c6bfdc9f065f0001bff,513cc616fdc9f03587001903,safer,3,1,4
50f5e63cfdc9f065f0006b6c,50f5eb68fdc9f065f00082b5,more depressing,4,0,4
50f5609afdc9f065f000528b,5140cbbdfdc9f04926002c38,safer,4,0,4
50f55e56fdc9f065f0004c18,513d7972fdc9f035870064d5,safer,3,1,4
50f55eb2fdc9f065f0004e35,51413b8ffdc9f049260059b5,wealthier,0,4,4
50f55eb2fdc9f065f0004e38,50f5e8a6fdc9f065f0007434,more boring,4,0,4
50f5e584fdc9f065f0006959,5140cc45fdc9f04926002d67,more depressing,0,4,4
513e1ff6fdc9f0358700a095,51413509fdc9f04926004894,safer,4,0,4
5140cb93fdc9f04926002bc9,51414043fdc9f04926006093,safer,0,4,4
50f56089fdc9f065f00051ad,513d9d9cfdc9f03587008123,safer,4,0,4
50f5608bfdc9f065f00051cc,513d9e26fdc9f035870082fa,more boring,0,4,4
513f2d71fdc9f0358700da3b,5185d298fdc9f03fd5001201,safer,4,0,4
513f2d3bfdc9f0358700d9d3,51408a6efdc9f0358700e70f,more depressing,0,4,4
50f44503fdc9f065f000337c,514133b0fdc9f049260043bb,wealthier,4,0,4
50f43bacfdc9f065f0003306,513f13a2fdc9f0358700cb33,safer,1,3,4
5139250e818ede129600101a,513d6a7efdc9f03587004a9b,safer,0,4,4
5139252c818ede1296001020,51414ff2fdc9f04926007c09,safer,3,1,4
513d6826fdc9f03587004289,51414eacfdc9f049260078e5,safer,0,4,4
513d682ffdc9f035870042a8,513f2a85fdc9f0358700d552,safer,0,4,4
513d6797fdc9f035870040f9,51421b2efdc9f04926008416,livelier,4,0,4
513d67aefdc9f03587004134,513d9ab6fdc9f0358700779b,safer,4,0,4
5139270a818ede12960010a0,513d6a50fdc9f03587004a1e,more beautiful,4,0,4
513924c8818ede1296001009,5140dadafdc9f04926003e3c,livelier,3,1,4
513e2058fdc9f0358700a199,514090affdc9f04926000352,more depressing,0,4,4
513e207dfdc9f0358700a201,51414d04fdc9f0492600749e,safer,4,0,4
513e2080fdc9f0358700a209,514135e3fdc9f04926004b75,livelier,3,1,4
513e2031fdc9f0358700a12d,514145f7fdc9f049260066de,livelier,0,4,4
50f5e690fdc9f065f0006d79,50f5eb3ffdc9f065f0008101,more depressing,0,4,4
50f5e63dfdc9f065f0006b90,513cc6e0fdc9f035870019c0,livelier,4,0,4
5140d6d9fdc9f049260036d0,5185cbe3fdc9f03fd5000ba3,safer,4,0,4
50f5e5d8fdc9f065f0006aaf,513d7f28fdc9f03587007565,safer,0,4,4
50f5e5d8fdc9f065f0006ab0,513f1453fdc9f0358700cc20,safer,4,0,4
5140d030fdc9f049260031f7,5185d44dfdc9f03fd50013b2,more boring,0,4,4
513d61a8fdc9f03587003e8c,51413433fdc9f04926004581,wealthier,0,4,4
513d61abfdc9f03587003e8f,51413a10fdc9f04926005601,safer,0,4,4
513d617afdc9f03587003e4d,5140b659fdc9f049260016bc,more boring,0,4,4
513d60edfdc9f03587003d9e,513f2a73fdc9f0358700d539,livelier,3,1,4
513d60fffdc9f03587003db7,513f2efafdc9f0358700dce1,more boring,4,0,4
513f2b2ffdc9f0358700d669,51408bc7fdc9f0358700e9d2,more beautiful,1,3,4
50f61670beb2fed910000862,513d5ca9fdc9f03587003768,more beautiful,0,4,4
50f61460beb2fed91000077e,5142192efdc9f049260081fd,safer,0,4,4
50f445a7fdc9f065f0003521,513cba5cfdc9f03587000dd2,livelier,3,1,4
50f445a8fdc9f065f0003540,50f561a0fdc9f065f000562e,livelier,0,4,4
513d685cfdc9f03587004343,5140cc28fdc9f04926002d28,livelier,4,0,4
513f2c9afdc9f0358700d8cc,51413cc2fdc9f04926005bb8,more beautiful,4,0,4
513d6868fdc9f0358700436a,513f2f32fdc9f0358700dd36,safer,4,0,4
513d67d6fdc9f03587004198,51409e27fdc9f049260013d6,more boring,0,4,4
513f29cffdc9f0358700d428,5140cdadfdc9f04926002f92,safer,4,0,4
50f60c49beb2fed910000232,50f60e70beb2fed91000061f,wealthier,4,0,4
50f60c44beb2fed9100001b0,51413943fdc9f04926005411,livelier,0,4,4
50f445a8fdc9f065f0003541,513cbc5cfdc9f03587000fad,more beautiful,1,3,4
50f44565fdc9f065f00034ae,51413553fdc9f0492600498f,wealthier,4,0,4
513d685ffdc9f03587004350,5140b6b2fdc9f049260017c6,wealthier,4,0,4
513d68a0fdc9f0358700443f,513d9f42fdc9f035870086aa,more depressing,0,4,4
50f60c49beb2fed910000228,513d4c66fdc9f03587002e2e,livelier,4,0,4
50f60c45beb2fed9100001c9,513d7f4dfdc9f035870075ac,safer,4,0,4
513d68c5fdc9f035870044be,5185d274fdc9f03fd50011e4,safer,4,0,4
513d9b3efdc9f0358700794f,513d9f19fdc9f03587008628,safer,1,3,4
513d9bd7fdc9f03587007b36,5140d7a0fdc9f0492600384c,safer,0,4,4
513d9be6fdc9f03587007b6c,513e5d52fdc9f0358700ad71,safer,1,3,4
50f55e97fdc9f065f0004d4b,5140b8fcfdc9f04926001d63,more boring,4,0,4
513d9bc9fdc9f03587007b0a,51421b0dfdc9f049260083f1,safer,1,3,4
513d9b61fdc9f035870079c3,51413ad5fdc9f049260057ec,more boring,0,4,4
513d9b38fdc9f03587007939,5140b842fdc9f04926001bea,safer,4,0,4
50f55e50fdc9f065f0004b96,513f310ffdc9f0358700df57,livelier,4,0,4
50f55eadfdc9f065f0004dd1,50f561cafdc9f065f00056f6,safer,0,4,4
513e2026fdc9f0358700a113,51413c7afdc9f04926005b30,safer,3,1,4
513e202dfdc9f0358700a122,514147a7fdc9f04926006ada,more beautiful,0,4,4
50f55e9bfdc9f065f0004d95,5185cd77fdc9f03fd5000d30,wealthier,4,0,4
50f55e7bfdc9f065f0004cdb,51408c4cfdc9f0358700ead2,more beautiful,4,0,4
513e20d0fdc9f0358700a2d6,5141349cfdc9f04926004705,wealthier,4,0,4
50f61677beb2fed9100008da,513d61affdc9f03587003e92,wealthier,4,0,4
513d68b9fdc9f03587004496,514090b2fdc9f0492600035c,livelier,0,4,4
50f6145fbeb2fed910000765,51413b9cfdc9f049260059d3,more depressing,1,3,4
50f61676beb2fed9100008c3,513925f8818ede1296001061,safer,4,0,4
50f447cefdc9f065f0003a1f,513d57dcfdc9f03587003234,more boring,3,1,4
513d690afdc9f035870045b0,513d6d15fdc9f035870050c5,livelier,4,0,4
513d6918fdc9f035870045e9,51414d4dfdc9f04926007561,livelier,4,0,4
50f445b0fdc9f065f00035d9,5140da4dfdc9f04926003dab,more depressing,0,4,4
50f445affdc9f065f00035cc,50f463b5fdc9f065f000426a,livelier,1,3,4
513f291afdc9f0358700d2eb,5140c877fdc9f04926002243,safer,3,1,4
513f293afdc9f0358700d317,513f2af1fdc9f0358700d602,wealthier,4,0,4
513f28bffdc9f0358700d24f,514137d8fdc9f04926005095,safer,1,3,4
513d6a00fdc9f0358700490c,51414afdfdc9f0492600701b,livelier,0,4,4
513d69d0fdc9f03587004876,51414f07fdc9f049260079be,more boring,0,4,4
513d69d3fdc9f03587004881,5140d90bfdc9f04926003b1c,livelier,0,4,4
513d69b8fdc9f0358700481f,513f1095fdc9f0358700c70c,more beautiful,4,0,4
513d69cbfdc9f03587004861,513d9b35fdc9f0358700792f,livelier,0,4,4
50f5e75afdc9f065f000703e,514137c3fdc9f04926005039,wealthier,0,4,4
50f5e75cfdc9f065f000706a,50f5ed5afdc9f065f0008c96,more beautiful,4,0,4
50f55e6dfdc9f065f0004c6e,5140b691fdc9f04926001774,safer,0,4,4
513d9c1bfdc9f03587007c1e,5140b689fdc9f0492600175b,more depressing,0,4,4
50f5e75efdc9f065f0007095,513cb2d2fdc9f035870006b5,safer,0,4,4
50f5e6fdfdc9f065f0006e90,513cc37cfdc9f0358700168f,livelier,3,1,4
50f5e649fdc9f065f0006c76,50f60e74beb2fed91000066d,safer,0,4,4
513d9c60fdc9f03587007d02,513f28e4fdc9f0358700d28a,safer,0,4,4
513d9c11fdc9f03587007bf6,513e6d7dfdc9f0358700c2d8,livelier,3,1,4
513d9c16fdc9f03587007c0a,513e6cb5fdc9f0358700c1ce,wealthier,3,1,4
513d9c0dfdc9f03587007beb,5141349efdc9f0492600470c,livelier,0,4,4
50f5e702fdc9f065f0006f29,513e1c57fdc9f035870096f6,livelier,4,0,4
513d6951fdc9f035870046aa,513e205bfdc9f0358700a1a3,safer,4,0,4
513d6956fdc9f035870046bf,5140b69dfdc9f04926001793,more depressing,0,4,4
50f60b92beb2fed9100000a4,513d581ffdc9f035870032ad,livelier,4,0,4
50f60b96beb2fed9100000de,513d5749fdc9f0358700313d,livelier,4,0,4
513f142dfdc9f0358700cbed,513f2dc6fdc9f0358700dace,safer,0,4,4
513d6963fdc9f035870046ef,51409a9dfdc9f04926000f7f,wealthier,1,3,4
50f447cffdc9f065f0003a3d,5140b65ffdc9f049260016cd,wealthier,4,0,4
50f60876beb2fed6f8000528,513f2fe1fdc9f0358700de5a,safer,0,4,4
50f42eaafdc9f065f00022c3,5140b8eefdc9f04926001d4b,livelier,0,4,4
50f447dafdc9f065f0003b71,50f44856fdc9f065f0003e9e,more beautiful,0,4,4
50f447d3fdc9f065f0003aaf,50f607cfbeb2fed6f8000246,safer,0,4,4
50f60870beb2fed6f80004ac,513e22a6fdc9f0358700a5a2,wealthier,0,4,4
50f60869beb2fed6f800041f,513d6979fdc9f03587004743,safer,4,0,4
513f1354fdc9f0358700cac3,5140b9fefdc9f04926001f51,livelier,1,3,4
513f138efdc9f0358700cb13,514138a0fdc9f04926005277,safer,3,1,4
50f6086dbeb2fed6f8000474,513d5d4bfdc9f0358700387f,safer,0,4,4
50f6086ebeb2fed6f8000487,513d3318fdc9f03587002930,more beautiful,0,4,4
513f113efdc9f0358700c7ec,51422e17fdc9f04926008cb7,livelier,3,1,4
514133b4fdc9f049260043cc,514141e5fdc9f04926006233,livelier,4,0,4
5140dc03fdc9f04926003f76,51421876fdc9f0492600813d,livelier,4,0,4
513d6aa3fdc9f03587004b01,513e6c15fdc9f0358700c0ff,wealthier,4,0,4
513d6ab7fdc9f03587004b34,513e1c3cfdc9f035870096ae,more boring,4,0,4
50f42c0dfdc9f065f00017bf,50f42c72fdc9f065f0001c95,more boring,1,3,4
50f5e76afdc9f065f000713d,513e6433fdc9f0358700b7cb,safer,0,4,4
50f5e87efdc9f065f0007332,5140b6b0fdc9f049260017bf,livelier,4,0,4
50f5e87efdc9f065f0007332,51413a28fdc9f0492600563e,livelier,0,4,4
50f5e76afdc9f065f0007175,513d9f69fdc9f0358700872a,more depressing,0,4,4
50f5e768fdc9f065f00070f4,513d5eb1fdc9f03587003ace,livelier,4,0,4
50f5e760fdc9f065f00070c5,513d5f22fdc9f03587003b62,wealthier,4,0,4
50f5e768fdc9f065f00070df,50f5ec9efdc9f065f0008aa5,wealthier,0,4,4
513e21ebfdc9f0358700a4c9,51408f95fdc9f04926000107,livelier,1,3,4
513e21b5fdc9f0358700a48d,51414e7dfdc9f0492600786a,livelier,0,4,4
513d6aebfdc9f03587004bbd,5140ca22fdc9f04926002748,livelier,4,0,4
50f607dbbeb2fed6f8000334,513d49d0fdc9f03587002dd4,livelier,0,4,4
513d6aa1fdc9f03587004afb,513e6ec4fdc9f0358700c49a,more beautiful,4,0,4
50f42bb0fdc9f065f00015f3,513e626dfdc9f0358700b6bf,safer,1,3,4
514133e6fdc9f0492600447d,51414cd1fdc9f04926007417,safer,4,0,4
50f42eedfdc9f065f00023e7,5140cfc2fdc9f0492600318a,safer,3,1,4
50f5eee4fdc9f065f000904c,513d9d70fdc9f03587008089,safer,0,4,4
513d6b55fdc9f03587004cc3,513e2148fdc9f0358700a40e,safer,4,0,4
513f1298fdc9f0358700c9c7,5140d671fdc9f04926003660,more depressing,0,4,4
5141338afdc9f0492600433a,514134e6fdc9f04926004812,more depressing,1,3,4
50f42ef0fdc9f065f0002428,513f10ecfdc9f0358700c786,more depressing,0,4,4
513f1257fdc9f0358700c966,513f30c5fdc9f0358700df1f,livelier,0,4,4
50f42eb3fdc9f065f00023aa,5140d1fefdc9f0492600326e,livelier,4,0,4
5140c835fdc9f0492600217b,5140cbb5fdc9f04926002c2d,wealthier,0,4,4
50f5ee9afdc9f065f0008f46,51392a50818ede1296001181,safer,4,0,4
513f12bafdc9f0358700c9f8,514137dbfdc9f049260050a0,more depressing,0,4,4
513f12e7fdc9f0358700ca32,514226d6fdc9f049260085db,livelier,1,3,4
50f5eeacfdc9f065f0008fa2,51409b6efdc9f0492600108c,safer,4,0,4
50f5ee99fdc9f065f0008f21,5140cc44fdc9f04926002d65,more beautiful,4,0,4
50f5ee9afdc9f065f0008f3a,513d6898fdc9f0358700441b,livelier,3,1,4
513e6f43fdc9f0358700c54e,51421addfdc9f049260083bb,more boring,3,1,4
50f44807fdc9f065f0003c9a,513e60e0fdc9f0358700b477,safer,4,0,4
513d7f60fdc9f035870075cd,51415024fdc9f04926007c88,livelier,0,4,4
50f55e35fdc9f065f0004b44,513e1bcefdc9f0358700957d,more depressing,0,4,4
50f5e705fdc9f065f0006f6e,513e22e6fdc9f0358700a5f4,safer,1,3,4
50f5e706fdc9f065f0006f97,513cc4eafdc9f035870017f0,livelier,4,0,4
513d9b2afdc9f0358700790c,51409e5efdc9f0492600141a,more boring,4,0,4
513d9a8efdc9f03587007708,5140d9c4fdc9f04926003c96,safer,0,4,4
513d7ff5fdc9f03587007675,5140c9e3fdc9f04926002688,wealthier,1,3,4
50f5eeedfdc9f065f0009114,513e6fbffdc9f0358700c5f5,livelier,3,1,4
513d6cabfdc9f03587005015,513e1c5efdc9f0358700970c,wealthier,4,0,4
50f5ed97fdc9f065f0008dee,513d5b5ffdc9f03587003521,more boring,0,4,4
50f5ecf5fdc9f065f0008bb3,51413ad7fdc9f049260057f0,safer,0,4,4
513d6dacfdc9f035870051b7,5141358cfdc9f04926004a4e,safer,3,1,4
513d6cc2fdc9f0358700503b,51422de5fdc9f04926008c8a,safer,4,0,4
513d6d0dfdc9f035870050ba,5140b6dffdc9f04926001844,safer,3,1,4
513d6c11fdc9f03587004e90,5140d896fdc9f04926003a39,safer,4,0,4
513d6c17fdc9f03587004ea3,514144dffdc9f04926006555,more boring,0,4,4
50f5ee93fdc9f065f0008e9c,5140cb63fdc9f04926002b3e,livelier,0,4,4
50f5ee95fdc9f065f0008ec5,513f1464fdc9f0358700cc3a,livelier,0,4,4
50f5ee96fdc9f065f0008ee3,513d7e3afdc9f0358700736f,safer,0,4,4
50f5eaa4fdc9f065f0007b6f,513f2bd6fdc9f0358700d77e,safer,4,0,4
513d7dfbfdc9f035870072f0,5140b869fdc9f04926001c41,safer,0,4,4
50f5e8a6fdc9f065f0007442,513e5e02fdc9f0358700af57,livelier,3,1,4
513d7d36fdc9f03587007146,513d9cbafdc9f03587007e34,safer,0,4,4
513d7d45fdc9f03587007171,513d9ad9fdc9f03587007811,safer,0,4,4
50f5e8a7fdc9f065f000745a,513d60e7fdc9f03587003d97,livelier,4,0,4
50f5e89afdc9f065f00073ff,50f5eba2fdc9f065f00083a2,safer,4,0,4
50f5e89afdc9f065f000740d,513e6148fdc9f0358700b512,more beautiful,4,0,4
50f55e35fdc9f065f0004b3b,513d7aedfdc9f035870069bd,safer,0,4,4
50f46497fdc9f065f000480d,513e2051fdc9f0358700a187,wealthier,4,0,4
513e5cb8fdc9f0358700abc9,513e6c42fdc9f0358700c140,more beautiful,4,0,4
513e5cbffdc9f0358700abde,513f152dfdc9f0358700cd53,livelier,0,4,4
50f5eeb2fdc9f065f000902f,513f334dfdc9f0358700e138,livelier,0,4,4
50f5ed98fdc9f065f0008dfa,5140898afdc9f0358700e52a,more beautiful,4,0,4
50f5ed6bfdc9f065f0008d6a,513f13d4fdc9f0358700cb6f,livelier,4,0,4
513d6c51fdc9f03587004f36,51408c74fdc9f0358700eb20,safer,1,3,4
513d6df2fdc9f03587005229,51422e18fdc9f04926008cb8,safer,0,4,4
513d6bf7fdc9f03587004e54,513d9c46fdc9f03587007ca8,safer,0,4,4
513d6bb6fdc9f03587004daf,513d6d09fdc9f035870050b3,safer,4,0,4
50f5eeb1fdc9f065f0009025,51421ae1fdc9f049260083c0,livelier,3,1,4
50f44855fdc9f065f0003e77,514137f4fdc9f049260050ed,safer,1,3,4
513d6e52fdc9f035870052ba,51409042fdc9f04926000266,more boring,0,4,4
50f44812fdc9f065f0003d69,513cca20fdc9f03587001cba,wealthier,0,4,4
50f5ed65fdc9f065f0008ceb,513d5768fdc9f03587003168,safer,0,4,4
50f5ed57fdc9f065f0008c43,51414ea6fdc9f049260078d9,livelier,0,4,4
50f44865fdc9f065f0003f7f,514094f9fdc9f0492600091e,more depressing,3,1,4
50f44814fdc9f065f0003df8,513d7c2dfdc9f03587006df0,livelier,4,0,4
50f44852fdc9f065f0003e1c,51414335fdc9f04926006391,livelier,0,4,4
50f44811fdc9f065f0003d59,51408f5afdc9f0492600009e,livelier,0,4,4
513e6c5cfdc9f0358700c163,513f2fe0fdc9f0358700de57,livelier,0,4,4
50f44866fdc9f065f0003fc1,51413937fdc9f049260053f5,livelier,0,4,4
50f44866fdc9f065f0003fc9,513d7c55fdc9f03587006e6d,more beautiful,1,3,4
50f4485dfdc9f065f0003f30,50f5e8c9fdc9f065f00074bd,livelier,0,4,4
50f5ec9cfdc9f065f0008a7a,513cc6f6fdc9f035870019d3,safer,4,0,4
50f5ec40fdc9f065f00088b0,513d9e1afdc9f035870082ce,safer,0,4,4
513e6c88fdc9f0358700c19a,51414b67fdc9f0492600709c,livelier,0,4,4
513e6b7dfdc9f0358700c031,51422ab5fdc9f04926008984,safer,3,1,4
513e6b4dfdc9f0358700bff0,513f13e3fdc9f0358700cb84,more beautiful,4,0,4
513e6a80fdc9f0358700bede,51413bc5fdc9f04926005a3a,safer,4,0,4
50f46484fdc9f065f00046b3,50f56089fdc9f065f00051a9,livelier,3,1,4
513d7eccfdc9f035870074a5,51422704fdc9f0492600860b,safer,0,4,4
50f55dd9fdc9f065f00049dc,513d9b8afdc9f03587007a42,more beautiful,4,0,4
5140d890fdc9f04926003a2f,51421cc9fdc9f049260085d1,safer,0,4,4
5140d7b3fdc9f04926003874,5185cf1afdc9f03fd5000ed0,livelier,1,3,4
513d7f70fdc9f035870075f3,5140c942fdc9f0492600249f,safer,0,4,4
513d7f86fdc9f03587007610,51413746fdc9f04926004e6d,safer,4,0,4
513d7f35fdc9f03587007583,5140c900fdc9f049260023e9,livelier,0,4,4
513d7d5ffdc9f035870071aa,513e615afdc9f0358700b52b,livelier,4,0,4
513e65a6fdc9f0358700b9ca,5142190bfdc9f049260081da,livelier,4,0,4
513d78d9fdc9f035870062e0,51409be3fdc9f04926001114,more beautiful,1,3,4
50f448a8fdc9f065f0004112,51414ceffdc9f04926007462,wealthier,4,0,4
513d7827fdc9f03587006084,514135adfdc9f04926004ac4,safer,4,0,4
513d78f6fdc9f03587006348,5140931afdc9f04926000746,livelier,0,4,4
513d78fdfdc9f0358700635b,51414f04fdc9f049260079b6,wealthier,0,4,4
513d7903fdc9f03587006371,513e5e38fdc9f0358700afe3,livelier,0,4,4
513d78ecfdc9f03587006324,513d9d40fdc9f03587007feb,livelier,0,4,4
513d7892fdc9f035870061f0,51421a7afdc9f04926008350,safer,0,4,4
513d78d9fdc9f035870062e1,51413fcefdc9f04926006016,wealthier,0,4,4
513d78e3fdc9f03587006308,513d7a7ffdc9f0358700685d,livelier,0,4,4
513d7cccfdc9f03587006ff2,513e1fdefdc9f0358700a04f,more beautiful,0,4,4
50f5eac8fdc9f065f0007cc8,513ce955fdc9f03587002309,safer,0,4,4
50f5eacdfdc9f065f0007d37,514140ccfdc9f0492600610f,more beautiful,4,0,4
513e5ce6fdc9f0358700ac44,5140ca49fdc9f049260027c0,livelier,0,4,4
50f5eab1fdc9f065f0007c57,513e6d2ffdc9f0358700c26e,safer,4,0,4
50f5eaaefdc9f065f0007c19,513e5ce1fdc9f0358700ac36,safer,0,4,4
513d7cf0fdc9f03587007064,51414e94fdc9f049260078a7,wealthier,0,4,4
50f4648efdc9f065f0004769,513d6ab1fdc9f03587004b29,livelier,1,3,4
5140d9fafdc9f04926003d06,5141475dfdc9f04926006a33,safer,0,4,4
5140da54fdc9f04926003dad,5185cb02fdc9f03fd5000ac9,safer,0,4,4
50f5eceffdc9f065f0008b1f,51408b64fdc9f0358700e909,safer,4,0,4
50f5ec3afdc9f065f0008843,513d9e64fdc9f035870083c3,wealthier,0,4,4
50f5ec1dfdc9f065f0008780,513d9dbafdc9f03587008190,more beautiful,4,0,4
50f5ec18fdc9f065f0008722,513ccd68fdc9f03587001d71,safer,4,0,4
513d78a1fdc9f0358700621d,513f2912fdc9f0358700d2de,more boring,4,0,4
50f5ebd4fdc9f065f000861a,50f6011ebeb2fed6f800018c,livelier,0,4,4
50f5ebd5fdc9f065f0008628,50f61456beb2fed9100006e7,livelier,0,4,4
50f5ecf1fdc9f065f0008b50,513e641afdc9f0358700b7a6,livelier,1,3,4
50f5ecf3fdc9f065f0008b7b,513cbb7cfdc9f03587000ee4,safer,0,4,4
50f4486afdc9f065f000409a,513f107ffdc9f0358700c6f0,wealthier,4,0,4
50f448b4fdc9f065f00041f5,50f46485fdc9f065f00046d2,safer,4,0,4
50f5eba7fdc9f065f00083ff,513d7fa6fdc9f03587007631,livelier,0,4,4
50f5ec17fdc9f065f0008706,51392a00818ede129600116c,wealthier,0,4,4
50f448a4fdc9f065f00040ba,513e1fddfdc9f0358700a04e,safer,4,0,4
513d790cfdc9f03587006398,51413b12fdc9f04926005887,more boring,0,4,4
50f448b4fdc9f065f0004205,513e1ef2fdc9f03587009dd3,safer,4,0,4
50f448acfdc9f065f000416a,50f5ec9efdc9f065f0008ab4,livelier,0,4,4
513e6473fdc9f0358700b826,51408951fdc9f0358700e4bb,livelier,3,1,4
50f5ebd5fdc9f065f0008631,5141511ffdc9f04926007ef1,livelier,0,4,4
50f42c1cfdc9f065f000192b,513d5e17fdc9f035870039e5,livelier,0,4,4
50f42c1afdc9f065f00018ba,50f61673beb2fed910000894,safer,1,3,4
513e5dbbfdc9f0358700ae97,51414691fdc9f04926006849,livelier,0,4,4
50f42c44fdc9f065f00019a4,513d7a0dfdc9f035870066d6,livelier,0,4,4
50f42c1cfdc9f065f0001936,50f44869fdc9f065f000407a,more depressing,0,4,4
513e5d8dfdc9f0358700ae18,51415149fdc9f04926007f55,safer,0,4,4
513e5d1cfdc9f0358700acdb,5185cc72fdc9f03fd5000c2f,more beautiful,1,3,4
50f5eaf0fdc9f065f0007e7e,5140b9e8fdc9f04926001f37,safer,4,0,4
50f5e8e4fdc9f065f00075d1,5140b77bfdc9f049260019f5,livelier,4,0,4
50f42c4dfdc9f065f0001aa0,50f4348afdc9f065f0002922,more depressing,3,1,4
50f42c52fdc9f065f0001acd,51414f2efdc9f04926007a22,wealthier,0,4,4
50f5eac7fdc9f065f0007cb3,5140ce07fdc9f04926002fea,wealthier,4,0,4
50f5eac7fdc9f065f0007cbd,5140d70cfdc9f04926003731,livelier,0,4,4
50f5e903fdc9f065f000765b,513e60e3fdc9f0358700b47c,safer,3,1,4
50f5e8e3fdc9f065f00075ab,513d9ba7fdc9f03587007aa2,more beautiful,0,4,4
50f5ebaafdc9f065f0008439,514136c3fdc9f04926004cc8,safer,4,0,4
50f5ebacfdc9f065f0008459,513d6a0dfdc9f03587004938,livelier,4,0,4
513d799cfdc9f03587006566,5140db46fdc9f04926003eb4,more depressing,4,0,4
513d7977fdc9f035870064eb,514094e0fdc9f04926000902,livelier,1,3,4
513d7979fdc9f035870064f4,514229c8fdc9f049260088a2,more beautiful,0,4,4
50f5eb6efdc9f065f000831e,5141484afdc9f04926006c69,safer,0,4,4
50f5ebb1fdc9f065f00084bc,513e612efdc9f0358700b4f0,livelier,0,4,4
50f5ebc5fdc9f065f00084d1,513e616efdc9f0358700b546,safer,4,0,4
50f5ebc6fdc9f065f00084e3,513d7ddafdc9f035870072a7,safer,0,4,4
513e6275fdc9f0358700b6cd,51409309fdc9f04926000732,more boring,4,0,4
513e6279fdc9f0358700b6d2,5140d8f5fdc9f04926003af9,wealthier,4,0,4
50f5eb41fdc9f065f0008120,513d9e46fdc9f03587008368,safer,0,4,4
50f5eba5fdc9f065f00083d7,51415137fdc9f04926007f26,safer,0,4,4
513d7a71fdc9f0358700682a,513e6487fdc9f0358700b83d,more depressing,0,4,4
50f42c09fdc9f065f000174b,513cc4a4fdc9f035870017ab,safer,1,3,4
50f42eb2fdc9f065f0002365,513f2f8ffdc9f0358700ddcd,more depressing,0,4,4
50f42eaefdc9f065f0002326,51422d1efdc9f04926008bd2,safer,0,4,4
50f42eaafdc9f065f00022c6,50f5eb6efdc9f065f0008332,wealthier,4,0,4
50f42eacfdc9f065f00022f2,50f607dabeb2fed6f8000314,livelier,4,0,4
513e5f4ffdc9f0358700b20d,5140ce0ffdc9f04926002ff2,safer,4,0,4
50f46456fdc9f065f0004609,513d5d04fdc9f03587003806,livelier,4,0,4
513d7c9bfdc9f03587006f56,5185d077fdc9f03fd500100d,more beautiful,3,1,4
50f5eaeffdc9f065f0007e6d,513d9deafdc9f0358700822e,wealthier,0,4,4
50f46457fdc9f065f000465d,51414465fdc9f049260064cf,safer,4,0,4
50f46456fdc9f065f000460f,51408f38fdc9f04926000051,safer,0,4,4
50f46457fdc9f065f0004631,513d9f75fdc9f03587008748,safer,0,4,4
513e61ddfdc9f0358700b5f2,5141352ffdc9f0492600490d,livelier,0,4,4
50f463c9fdc9f065f000439a,513f2b23fdc9f0358700d658,safer,0,4,4
50f463c6fdc9f065f000432e,50f46498fdc9f065f0004851,wealthier,4,0,4
50f463c7fdc9f065f0004359,5140ca81fdc9f0492600286a,livelier,0,4,4
50f5eb60fdc9f065f0008209,513ce94dfdc9f03587002307,livelier,0,4,4
513e5f8afdc9f0358700b264,513e6f52fdc9f0358700c55f,livelier,4,0,4
50f5eb48fdc9f065f00081a6,513d7ef8fdc9f035870074ff,wealthier,0,4,4
50f5eb4cfdc9f065f00081ea,513e5e65fdc9f0358700b065,livelier,1,3,4
513e608efdc9f0358700b3f5,5141501efdc9f04926007c7b,more beautiful,0,4,4
513e609ffdc9f0358700b40f,51408a19fdc9f0358700e66b,safer,0,4,4
513e5ff9fdc9f0358700b30e,51414caffdc9f049260073c2,safer,4,0,4
513e6029fdc9f0358700b358,51409376fdc9f049260007a1,safer,0,4,4
513e5f7efdc9f0358700b255,5140d7cdfdc9f049260038ab,more boring,0,4,4
50f4644cfdc9f065f0004525,51408fd8fdc9f04926000191,safer,0,4,4
50f46445fdc9f065f00044b1,513e6e03fdc9f0358700c39d,more boring,3,1,4
5140ca8efdc9f04926002895,51413425fdc9f0492600454a,more boring,4,0,4
5140ca93fdc9f049260028a5,5140d7ecfdc9f049260038ed,more beautiful,4,0,4
5140ca27fdc9f04926002759,5185d0c4fdc9f03fd5001052,livelier,1,3,4
5140ca58fdc9f049260027eb,51422e17fdc9f04926008cb7,more beautiful,0,4,4
513e5e4ffdc9f0358700b022,51422a16fdc9f049260088df,safer,0,4,4
513e5e54fdc9f0358700b034,5141484bfdc9f04926006c6b,safer,0,4,4
50f5eaf6fdc9f065f0007efb,50f5ed52fdc9f065f0008bca,livelier,1,3,4
513d7af9fdc9f035870069e2,513d7cd2fdc9f03587007006,more boring,4,0,4
513d7ba5fdc9f03587006c28,5141345ffdc9f0492600462c,safer,4,0,4
513d7ba9fdc9f03587006c35,5141332ffdc9f049260041ff,safer,0,4,4
513d7b7afdc9f03587006b9a,5140da21fdc9f04926003d59,safer,0,4,4
513d7b7efdc9f03587006bad,513e1cb3fdc9f035870097e4,safer,3,1,4
513d7b40fdc9f03587006ad1,5141484dfdc9f04926006c70,more boring,4,0,4
50f5eb41fdc9f065f0008116,513d2d1efdc9f0358700249d,livelier,0,4,4
50f5eb3bfdc9f065f00080b5,513da063fdc9f03587008976,more depressing,0,4,4
513d7c42fdc9f03587006e33,513f117efdc9f0358700c840,livelier,4,0,4
513d7b08fdc9f03587006a1b,5140b62efdc9f04926001644,livelier,4,0,4
50f5eae8fdc9f065f0007de7,513d5787fdc9f0358700319e,safer,1,3,4
50f5ead2fdc9f065f0007d96,514138aefdc9f0492600529c,more depressing,1,3,4
513d7c70fdc9f03587006ec8,513e1b0efdc9f0358700937c,livelier,0,4,4
513d7be8fdc9f03587006d06,513d7e15fdc9f03587007320,livelier,4,0,4
513d2f86fdc9f0358700266a,51408b20fdc9f0358700e87f,safer,0,4,4
513e1bd4fdc9f03587009592,51422822fdc9f0492600871c,more boring,3,1,4
513e1be0fdc9f035870095b1,5140d9a2fdc9f04926003c50,safer,4,0,4
50f56260fdc9f065f00059c0,513d7bc8fdc9f03587006ca0,livelier,0,4,4
50f56258fdc9f065f0005937,513d5de9fdc9f03587003990,livelier,4,0,4
50f56203fdc9f065f0005893,51408c9ffdc9f0358700eb73,livelier,1,3,4
513e1b9dfdc9f035870094ff,513f10eefdc9f0358700c789,safer,4,0,4
50e748ead7c3df413b00146d,513e64a9fdc9f0358700b871,safer,4,0,4
51414b2efdc9f04926007054,51422ac7fdc9f04926008995,safer,0,4,4
50f42b53fdc9f065f000139c,513f2e76fdc9f0358700dbfc,livelier,4,0,4
50f42b4ffdc9f065f00012b6,513e1b22fdc9f035870093b7,safer,0,4,4
50f42b49fdc9f065f0001282,51408cc1fdc9f0358700ebb7,safer,4,0,4
513d3007fdc9f035870026d1,51414b77fdc9f049260070b8,safer,3,1,4
514150b2fdc9f04926007dfa,5142183cfdc9f049260080fd,safer,4,0,4
5140b741fdc9f04926001959,5140cf81fdc9f0492600314c,livelier,4,0,4
51413ff1fdc9f0492600603d,51414d91fdc9f04926007611,livelier,4,0,4
50f42b4ffdc9f065f00012ad,5140d34cfdc9f049260033a6,more depressing,0,4,4
513d2e65fdc9f03587002591,513d698cfdc9f03587004784,more beautiful,0,3,3
50e748e9d7c3df413b00142a,50f61673beb2fed910000886,livelier,0,3,3
50e5f7d7d7c3df413b000589,50f5eb44fdc9f065f0008157,wealthier,3,0,3
514147e1fdc9f04926006b6a,51422ac2fdc9f04926008990,livelier,0,3,3
514147e4fdc9f04926006b71,51414881fdc9f04926006ce4,safer,2,1,3
514147f0fdc9f04926006b90,51422de3fdc9f04926008c88,safer,3,0,3
514141a9fdc9f049260061f3,51415110fdc9f04926007ed1,wealthier,3,0,3
513d350ffdc9f03587002a96,513f14b0fdc9f0358700cca6,safer,3,0,3
513d351cfdc9f03587002a9f,513f30bffdc9f0358700df18,more beautiful,3,0,3
50f433cffdc9f065f00026da,513d9c5efdc9f03587007cf7,more beautiful,0,3,3
50f433c5fdc9f065f0002669,50f5e89afdc9f065f0007408,livelier,3,0,3
50f433cdfdc9f065f00026a6,513f2dc8fdc9f0358700dad1,livelier,0,3,3
50f433cdfdc9f065f00026b4,51414835fdc9f04926006c31,livelier,0,3,3
50f433c1fdc9f065f0002619,50f5e5d6fdc9f065f0006a9e,livelier,0,3,3
513ce2edfdc9f035870021d1,51414c9bfdc9f0492600738e,safer,0,3,3
50f56361fdc9f065f0005cf9,50f5eaf5fdc9f065f0007ee3,more depressing,0,3,3
50f56361fdc9f065f0005cfe,513d9ebdfdc9f035870084e0,livelier,2,1,3
50f56362fdc9f065f0005d17,513e6fd4fdc9f0358700c610,safer,3,0,3
50f5635ffdc9f065f0005cbe,5185d3c7fdc9f03fd5001329,safer,3,0,3
513e1a97fdc9f03587009256,513e604ffdc9f0358700b394,wealthier,3,0,3
513e1aaefdc9f0358700928f,513f135efdc9f0358700cad0,livelier,0,3,3
513e1ad0fdc9f035870092e3,51414769fdc9f04926006a50,livelier,0,3,3
51409d26fdc9f0492600129f,51421954fdc9f0492600821d,livelier,0,3,3
513d33b4fdc9f03587002998,5140ca01fdc9f049260026db,safer,3,0,3
513d3438fdc9f035870029fb,513d5fcdfdc9f03587003c3d,wealthier,0,3,3
513d3330fdc9f0358700293f,513e1d17fdc9f035870098ed,safer,0,3,3
513d3344fdc9f0358700294e,514089bcfdc9f0358700e5a4,more depressing,0,3,3
513ceb4ffdc9f03587002366,5140da17fdc9f04926003d46,more boring,3,0,3
513d2f68fdc9f03587002650,5185d316fdc9f03fd500126e,livelier,3,0,3
513e1a2cfdc9f03587009135,514146a7fdc9f04926006877,more depressing,1,2,3
513e1a4afdc9f03587009184,5141506afdc9f04926007d3f,safer,3,0,3
51409d1efdc9f04926001293,5140cb2bfdc9f04926002a86,wealthier,3,0,3
514150a4fdc9f04926007dd6,5185cc9efdc9f03fd5000c56,livelier,3,0,3
513ce81bfdc9f035870022c5,513e2123fdc9f0358700a3c0,more beautiful,3,0,3
513ce921fdc9f035870022ff,513d67effdc9f035870041d4,more beautiful,1,2,3
513ce9a5fdc9f03587002315,514143d1fdc9f04926006439,livelier,2,1,3
513ce75ffdc9f035870022a3,513d2e14fdc9f03587002553,livelier,3,0,3
513ce783fdc9f035870022a7,5140d54ffdc9f04926003472,more beautiful,0,3,3
513ce3dbfdc9f035870021f2,51413cfcfdc9f04926005c37,safer,0,3,3
513d7a8bfdc9f03587006888,513e65c8fdc9f0358700b9fa,more boring,0,3,3
50f5eb3dfdc9f065f00080d1,5140923dfdc9f04926000676,more beautiful,3,0,3
50f5eb3efdc9f065f00080e5,513d5b3bfdc9f035870034db,safer,2,1,3
513d7af9fdc9f035870069e4,513f2c63fdc9f0358700d86f,more beautiful,1,2,3
513d7b23fdc9f03587006a6d,513e5f30fdc9f0358700b1de,safer,2,1,3
513d7b37fdc9f03587006ab1,5140d8cdfdc9f04926003ab5,safer,1,2,3
513e5e44fdc9f0358700b000,51414f9bfdc9f04926007b2e,livelier,1,2,3
50f5eaf4fdc9f065f0007ed1,513d9ecbfdc9f0358700850f,safer,2,1,3
513d7c62fdc9f03587006e94,513d7d50fdc9f0358700718c,wealthier,3,0,3
513d7c83fdc9f03587006f0d,5140ca29fdc9f0492600275e,wealthier,3,0,3
513d7b03fdc9f03587006a09,513d9b27fdc9f03587007902,safer,1,2,3
513d7acffdc9f03587006966,514134a2fdc9f0492600471a,livelier,2,1,3
513d7ad6fdc9f03587006979,51413506fdc9f04926004887,more boring,0,3,3
513d7adffdc9f03587006994,5140905dfdc9f049260002a1,more beautiful,1,2,3
513d7abefdc9f0358700692f,5185cfcbfdc9f03fd5000f85,livelier,3,0,3
513d7acffdc9f03587006966,513d7ceffdc9f03587007062,safer,3,0,3
513d7baafdc9f03587006c39,5140d2c2fdc9f04926003328,safer,0,3,3
513d7bb2fdc9f03587006c52,51408aaefdc9f0358700e78c,wealthier,2,1,3
513d7bcefdc9f03587006cae,51414f30fdc9f04926007a27,livelier,3,0,3
50f5eb1bfdc9f065f0007f99,513f2d96fdc9f0358700da77,wealthier,0,3,3
50f5eb1dfdc9f065f0007fcb,513e6202fdc9f0358700b628,livelier,0,3,3
50f5eaf9fdc9f065f0007f29,51421b49fdc9f04926008430,livelier,0,3,3
50f5eb17fdc9f065f0007f4f,513d6b04fdc9f03587004bfe,livelier,0,3,3
50f5ead2fdc9f065f0007d91,5140d75afdc9f049260037c2,wealthier,0,3,3
50f56204fdc9f065f00058ce,513d5c3dfdc9f035870036a0,more boring,3,0,3
513e1bd2fdc9f0358700958a,51414f10fdc9f049260079d5,more boring,3,0,3
513e1b9dfdc9f035870094ff,51414de9fdc9f049260076f8,safer,3,0,3
513e1bd8fdc9f0358700959d,513f12ddfdc9f0358700ca26,livelier,0,3,3
513e1c1bfdc9f03587009651,51422a86fdc9f04926008956,safer,3,0,3
5140b726fdc9f0492600190d,5140d69bfdc9f0492600368d,more boring,0,3,3
50f42eaefdc9f065f0002311,513d32b4fdc9f035870028e7,wealthier,1,2,3
50f42eaefdc9f065f0002325,513d7f4cfdc9f035870075a9,livelier,2,1,3
513e6077fdc9f0358700b3d0,51422e2bfdc9f04926008cc7,safer,0,3,3
513e607ffdc9f0358700b3dd,513e65d8fdc9f0358700ba0c,safer,0,3,3
50f42c1bfdc9f065f0001901,513d5948fdc9f0358700337b,more beautiful,0,3,3
513e61f2fdc9f0358700b611,513e65d1fdc9f0358700ba05,safer,0,3,3
50f463c8fdc9f065f0004375,513d697cfdc9f0358700474e,more boring,0,3,3
513e5d4afdc9f0358700ad5b,51413b0dfdc9f04926005875,livelier,0,3,3
513e5d76fdc9f0358700adda,514135cbfdc9f04926004b39,more beautiful,3,0,3
513e5dfefdc9f0358700af4c,5140b74ffdc9f0492600197d,more depressing,0,3,3
50f5eb63fdc9f065f0008256,51408a9bfdc9f0358700e75f,safer,0,3,3
50f5eb4bfdc9f065f00081df,51414008fdc9f04926006058,safer,0,3,3
50f5eb5ffdc9f065f00081fa,513f28a8fdc9f0358700d22a,livelier,3,0,3
50f5eb60fdc9f065f0008207,5141460ffdc9f04926006711,safer,0,3,3
513e60a2fdc9f0358700b415,5140d582fdc9f049260034d4,livelier,2,1,3
513e60dafdc9f0358700b46e,5140c952fdc9f049260024d1,more beautiful,0,3,3
513e60defdc9f0358700b473,513f2b54fdc9f0358700d6a7,safer,3,0,3
513e6041fdc9f0358700b37e,51422c8afdc9f04926008b40,livelier,1,2,3
50f4643efdc9f065f0004418,51414e88fdc9f04926007889,livelier,0,3,3
50f46440fdc9f065f000444a,50f5ee94fdc9f065f0008ea5,safer,0,3,3
50f46442fdc9f065f0004467,51422a96fdc9f04926008966,safer,0,3,3
50f46443fdc9f065f000448b,5185d2cefdc9f03fd5001234,livelier,3,0,3
5140ca8cfdc9f0492600288b,5141441bfdc9f04926006487,more boring,0,3,3
50f5eb44fdc9f065f0008158,513e1ad8fdc9f035870092f5,safer,0,3,3
50f46448fdc9f065f00044ff,513d5ef3fdc9f03587003b26,more beautiful,0,3,3
513d7aa2fdc9f035870068d9,514142eefdc9f04926006347,wealthier,0,3,3
50f5eaf6fdc9f065f0007efe,50f5ec3efdc9f065f0008896,safer,0,3,3
50f5eaf2fdc9f065f0007ea1,513e6c47fdc9f0358700c148,wealthier,3,0,3
50f5eaf3fdc9f065f0007ead,51414c5afdc9f049260072f6,livelier,0,3,3
5140c9d8fdc9f04926002667,514228f3fdc9f049260087ee,more boring,0,3,3
5140ca2efdc9f0492600276c,51414210fdc9f0492600625e,more boring,3,0,3
5140c96dfdc9f04926002526,514150b6fdc9f04926007e03,livelier,0,3,3
5140c972fdc9f04926002534,51422a54fdc9f0492600891f,livelier,2,1,3
50f4644cfdc9f065f0004534,50f607d6beb2fed6f80002d6,livelier,1,2,3
50f5eba3fdc9f065f00083b1,514138aefdc9f0492600529d,safer,3,0,3
50f5eba4fdc9f065f00083c4,5140ca30fdc9f04926002772,more beautiful,0,3,3
50f5eba5fdc9f065f00083d3,5140b9dbfdc9f04926001f24,livelier,3,0,3
50f5eba1fdc9f065f0008398,513d617bfdc9f03587003e4e,more depressing,0,3,3
50f5ebb1fdc9f065f00084bf,514139d7fdc9f0492600556f,livelier,3,0,3
50f5ebc6fdc9f065f00084e8,514135b8fdc9f04926004af2,safer,0,3,3
50f5eba8fdc9f065f0008416,513ce099fdc9f03587002163,livelier,2,1,3
513d7958fdc9f03587006485,513d9dadfdc9f03587008169,livelier,3,0,3
50f42eb2fdc9f065f0002395,50f5eb1cfdc9f065f0007fbc,livelier,0,3,3
50f463b8fdc9f065f00042ad,5140d79cfdc9f04926003844,more beautiful,3,0,3
50f463b3fdc9f065f000424b,513cb2a0fdc9f03587000688,more boring,0,3,3
513d7a67fdc9f03587006805,514139f0fdc9f049260055a9,safer,3,0,3
50f42c0bfdc9f065f0001782,50f447cefdc9f065f0003a23,more boring,3,0,3
50f42c0bfdc9f065f000178c,51413853fdc9f049260051c9,wealthier,3,0,3
50f42c09fdc9f065f0001749,51422debfdc9f04926008c8f,safer,0,3,3
50f5eb41fdc9f065f000811e,51421c44fdc9f0492600853a,more beautiful,0,3,3
50f42eabfdc9f065f00022e3,5141440ffdc9f0492600647e,more beautiful,0,3,3
50f42eacfdc9f065f00022f6,513d7b74fdc9f03587006b8a,safer,0,3,3
513e5e58fdc9f0358700b03e,513f2b5afdc9f0358700d6b1,more beautiful,2,1,3
513e5ed9fdc9f0358700b15f,5140b8bcfdc9f04926001cea,safer,1,2,3
50f5eb17fdc9f065f0007f54,513d3288fdc9f035870028c7,wealthier,0,3,3
5140c944fdc9f049260024a9,51414fa0fdc9f04926007b39,more boring,3,0,3
5140c95dfdc9f049260024f4,5185cebdfdc9f03fd5000e70,safer,1,2,3
50f42eb2fdc9f065f0002385,50f5e8cafdc9f065f00074de,more depressing,3,0,3
513e5e18fdc9f0358700af91,5140cc12fdc9f04926002ced,safer,2,1,3
50f46483fdc9f065f000468b,5141344dfdc9f049260045e6,more beautiful,0,3,3
50f46455fdc9f065f00045c6,513d7984fdc9f03587006515,safer,0,3,3
513d7cd6fdc9f03587007019,513d9d63fdc9f0358700805c,safer,3,0,3
513d7c9cfdc9f03587006f58,513f2efdfdc9f0358700dce6,more boring,2,1,3
513d7cb0fdc9f03587006f95,51413c66fdc9f04926005b16,more boring,2,1,3
50f5eaf0fdc9f065f0007e6e,513e6f96fdc9f0358700c5c0,livelier,1,2,3
513e5dfbfdc9f0358700af43,5140b918fdc9f04926001d9a,more boring,3,0,3
50f42c13fdc9f065f000184c,51414bacfdc9f0492600713a,more depressing,0,3,3
513d797bfdc9f035870064f8,51414e04fdc9f04926007734,livelier,0,3,3
513d7980fdc9f03587006509,5140c98dfdc9f04926002584,more beautiful,3,0,3
513d7989fdc9f03587006525,51422ad0fdc9f049260089a0,safer,0,3,3
513d798efdc9f03587006533,5140cbd7fdc9f04926002c71,safer,1,2,3
50f42c1afdc9f065f000188e,50f5e688fdc9f065f0006cd7,safer,0,3,3
50f42c1afdc9f065f000189e,50f5e706fdc9f065f0006f9b,livelier,3,0,3
50f42c1afdc9f065f00018aa,51408b0dfdc9f0358700e860,livelier,0,3,3
50f4644dfdc9f065f0004553,513d9b8bfdc9f03587007a46,more beautiful,3,0,3
50f4644dfdc9f065f0004556,50f55e50fdc9f065f0004b9e,more beautiful,1,2,3
513e5dc2fdc9f0358700aea8,5140c973fdc9f0492600253b,more boring,3,0,3
513d794cfdc9f03587006462,5140ca45fdc9f049260027b4,safer,1,2,3
513d7953fdc9f03587006473,51413b97fdc9f049260059c2,safer,2,1,3
50f42c13fdc9f065f0001855,513928a8818ede1296001110,more boring,3,0,3
50f42c13fdc9f065f0001862,50f56360fdc9f065f0005ce6,livelier,3,0,3
50f42c1afdc9f065f0001883,513d79cafdc9f035870065f2,safer,0,3,3
50f42c46fdc9f065f00019da,513f2f4dfdc9f0358700dd62,more beautiful,3,0,3
50f42c1efdc9f065f0001978,513d6893fdc9f03587004405,more depressing,3,0,3
513e5d94fdc9f0358700ae2b,5140c913fdc9f04926002422,livelier,0,3,3
513e5d23fdc9f0358700acf3,514135b5fdc9f04926004ae4,livelier,0,3,3
50f5eaedfdc9f065f0007e3f,5185cc98fdc9f03fd5000c51,more beautiful,3,0,3
50f5ead4fdc9f065f0007daa,51422e47fdc9f04926008ce8,wealthier,3,0,3
50f5eae8fdc9f065f0007de5,513cd038fdc9f03587001df8,safer,3,0,3
50f4644dfdc9f065f000454b,513cb9f3fdc9f03587000d71,safer,3,0,3
513d7975fdc9f035870064e2,51408a96fdc9f0358700e75a,safer,0,3,3
513d794afdc9f0358700645b,514142fdfdc9f04926006355,safer,3,0,3
50f42c1cfdc9f065f000193a,513d9b08fdc9f035870078a4,wealthier,3,0,3
50f5ea5efdc9f065f0007af4,514147aefdc9f04926006aea,livelier,3,0,3
50f5e8e0fdc9f065f000755f,50f5ec41fdc9f065f00088d4,safer,3,0,3
50f5e8e3fdc9f065f000759f,513d5cdafdc9f035870037bb,more depressing,3,0,3
5140d811fdc9f04926003934,51421a4cfdc9f04926008321,livelier,1,2,3
50f42c4cfdc9f065f0001a79,50f607e3beb2fed6f80003b7,livelier,3,0,3
50f5eceefdc9f065f0008afe,50f5eeacfdc9f065f0008fae,safer,3,0,3
50f5ecf0fdc9f065f0008b27,51415195fdc9f04926007fc0,safer,3,0,3
50f5ec19fdc9f065f0008726,513d7abefdc9f03587006930,livelier,1,2,3
513d7897fdc9f03587006200,513e1ca0fdc9f035870097b6,livelier,3,0,3
50f46485fdc9f065f00046c3,5140d538fdc9f04926003449,more boring,2,1,3
50f55dd8fdc9f065f00049d6,513e1a68fdc9f035870091d4,wealthier,3,0,3
513e5cf3fdc9f0358700ac67,513e6e18fdc9f0358700c3b9,more boring,3,0,3
513e5d17fdc9f0358700acd1,5141484ffdc9f04926006c72,livelier,0,3,3
50f44869fdc9f065f0004070,50f5625ffdc9f065f00059aa,livelier,3,0,3
50f5eba6fdc9f065f00083e4,51392b3e818ede12960011ca,livelier,0,3,3
50f5eba6fdc9f065f00083ec,513cbd10fdc9f0358700104b,more beautiful,3,0,3
50f5eba7fdc9f065f00083fc,50f5ed63fdc9f065f0008cbc,more boring,0,3,3
50f5ec13fdc9f065f00086bf,5140d03afdc9f04926003205,more depressing,0,3,3
513d7843fdc9f035870060e4,51414f13fdc9f049260079db,wealthier,0,3,3
50f5ecf0fdc9f065f0008b3d,513e233dfdc9f0358700a652,more depressing,0,3,3
50f5ecf2fdc9f065f0008b66,51414ff2fdc9f04926007c09,wealthier,3,0,3
50f448b4fdc9f065f0004211,514091eefdc9f049260005ed,safer,3,0,3
50f448b5fdc9f065f0004229,513d5f03fdc9f03587003b3a,safer,0,3,3
50f448affdc9f065f00041a4,5140b7b0fdc9f04926001a91,livelier,0,3,3
50f448b1fdc9f065f00041e1,513cc9eafdc9f03587001c90,livelier,0,3,3
50f448adfdc9f065f0004189,513d6a04fdc9f03587004918,safer,3,0,3
50f448adfdc9f065f000418a,51414d9ffdc9f04926007639,wealthier,0,3,3
50f448a9fdc9f065f0004126,51409031fdc9f04926000247,safer,0,3,3
50f448a4fdc9f065f00040bd,50f5e87efdc9f065f000733e,livelier,0,3,3
50f42c1bfdc9f065f00018f0,513d59c0fdc9f035870033b7,safer,3,0,3
50f42c1bfdc9f065f00018f6,513d68d9fdc9f035870044fe,livelier,2,1,3
50f42c13fdc9f065f000184d,51408ae3fdc9f0358700e805,safer,0,3,3
50f448abfdc9f065f000415e,5140b863fdc9f04926001c30,more depressing,1,2,3
50f5ebcffdc9f065f00085af,51392b4c818ede12960011cc,safer,3,0,3
50f5ebd2fdc9f065f00085e6,5185ce39fdc9f03fd5000df0,safer,0,3,3
50f5ebc9fdc9f065f000852c,514217dcfdc9f04926008093,more boring,3,0,3
50f5ebcafdc9f065f0008543,50f5ec15fdc9f065f00086e8,wealthier,3,0,3
513d78ecfdc9f03587006327,51409b42fdc9f04926001052,safer,0,3,3
513d78d1fdc9f035870062cb,513d9b69fdc9f035870079da,livelier,0,3,3
50f448a7fdc9f065f00040ff,51421c9afdc9f0492600859b,more beautiful,0,3,3
50f448a8fdc9f065f0004113,513e5fdafdc9f0358700b2dc,more beautiful,0,3,3
50f5ec41fdc9f065f00088cf,513e20ebfdc9f0358700a325,safer,2,1,3
513d7826fdc9f0358700607f,514137e2fdc9f049260050b8,safer,3,0,3
513d782afdc9f0358700608c,5140d99efdc9f04926003c45,livelier,3,0,3
513d782bfdc9f03587006091,513e1d11fdc9f035870098da,safer,3,0,3
513d784bfdc9f035870060fe,513d9d32fdc9f03587007fbb,safer,0,3,3
513d78dbfdc9f035870062ec,5140b7adfdc9f04926001a89,livelier,3,0,3
513d78defdc9f035870062f7,513d9c7afdc9f03587007d59,more depressing,1,2,3
513d78e0fdc9f035870062fc,5141508bfdc9f04926007d99,wealthier,3,0,3
50f5ec3bfdc9f065f000884f,51422e41fdc9f04926008ce0,safer,3,0,3
50f5ec3bfdc9f065f0008862,5140ca5bfdc9f049260027f5,livelier,0,3,3
50f5ec37fdc9f065f0008803,5140cd42fdc9f04926002f22,safer,0,3,3
513d78fdfdc9f0358700635b,513d9cd9fdc9f03587007e9e,more beautiful,3,0,3
50f5eaacfdc9f065f0007bff,513e6c62fdc9f0358700c16b,wealthier,0,3,3
513d7d06fdc9f035870070ac,51421822fdc9f049260080e2,more depressing,3,0,3
513d7ce6fdc9f03587007045,513e1d62fdc9f035870099b1,more boring,0,3,3
513d7cbafdc9f03587006fb5,51413cabfdc9f04926005b84,safer,0,3,3
50f5eac9fdc9f065f0007ce1,51409893fdc9f04926000cd5,safer,1,2,3
50f5eacbfdc9f065f0007d0c,513cbdc6fdc9f035870010ff,more beautiful,3,0,3
50f5eac5fdc9f065f0007c8d,50f5eb6dfdc9f065f0008319,livelier,3,0,3
50f5eac6fdc9f065f0007ca1,5140ca12fdc9f0492600270a,livelier,1,2,3
50f4648ffdc9f065f00047b2,50f61677beb2fed9100008da,more boring,3,0,3
50f4648ffdc9f065f00047bc,513d585dfdc9f035870032eb,safer,3,0,3
50f4648efdc9f065f000477a,513cd7bafdc9f03587001f89,livelier,3,0,3
50f5eaa5fdc9f065f0007b7e,5140d6adfdc9f049260036a2,safer,3,0,3
5140da39fdc9f04926003d88,51421855fdc9f04926008119,livelier,3,0,3
5140d8dbfdc9f04926003ad1,51414e23fdc9f04926007780,more beautiful,3,0,3
5140d96cfdc9f04926003be7,51414c56fdc9f049260072ed,livelier,3,0,3
513e5cdefdc9f0358700ac2f,514137dffdc9f049260050b0,safer,0,3,3
50f46485fdc9f065f00046c5,50f561f3fdc9f065f00057b3,safer,1,2,3
50f46485fdc9f065f00046c6,50f5e6cafdc9f065f0006e54,livelier,1,2,3
50f4648afdc9f065f0004714,50f562e3fdc9f065f0005b7d,livelier,3,0,3
50f4648efdc9f065f0004757,513d7b27fdc9f03587006a7d,livelier,3,0,3
513e64f3fdc9f0358700b8d9,513f2d91fdc9f0358700da73,livelier,0,3,3
513e653ffdc9f0358700b93d,513e6c1afdc9f0358700c107,livelier,3,0,3
513e6b63fdc9f0358700c00c,51414cf3fdc9f0492600746f,livelier,2,1,3
513e6b68fdc9f0358700c013,5185cc71fdc9f03fd5000c2e,safer,0,3,3
513d7f86fdc9f03587007611,51413aabfdc9f04926005781,livelier,0,3,3
50f5e8cffdc9f065f000753a,513e1f5cfdc9f03587009eea,livelier,0,3,3
50f55dd9fdc9f065f00049e0,50f56433fdc9f065f0006197,safer,3,0,3
50f55e07fdc9f065f00049e6,513cc272fdc9f0358700158a,safer,3,0,3
5140d77cfdc9f04926003805,51414265fdc9f049260062bb,wealthier,3,0,3
5140d7e5fdc9f049260038dd,5141495cfdc9f04926006dcd,safer,3,0,3
5140d7fdfdc9f04926003914,5185cc97fdc9f03fd5000c50,livelier,3,0,3
50f4648ffdc9f065f0004797,51415186fdc9f04926007fb5,livelier,0,3,3
50f5e8cefdc9f065f0007526,513d59d0fdc9f035870033bf,livelier,1,2,3
50f5e8cffdc9f065f0007530,513e1ddbfdc9f03587009ae9,wealthier,0,3,3
50f5e8c8fdc9f065f00074aa,50f5eaf6fdc9f065f0007ef9,livelier,0,3,3
50f5e8c9fdc9f065f00074b4,5185d11afdc9f03fd5001097,livelier,0,3,3
50f5e8c9fdc9f065f00074c2,513f2f53fdc9f0358700dd6d,more boring,0,3,3
50f5e8cbfdc9f065f00074ee,513e1b0efdc9f0358700937d,safer,3,0,3
513d7f65fdc9f035870075d7,513e1cd7fdc9f03587009840,more boring,1,2,3
513d7f67fdc9f035870075de,51409e34fdc9f049260013e6,livelier,0,3,3
513e654cfdc9f0358700b94b,5140c871fdc9f04926002234,livelier,0,3,3
513e659afdc9f0358700b9b5,5140c9f3fdc9f049260026b8,safer,0,3,3
513e659afdc9f0358700b9b5,51414319fdc9f04926006373,safer,3,0,3
513e64e1fdc9f0358700b8c1,513e6dd8fdc9f0358700c35c,livelier,3,0,3
513e64e1fdc9f0358700b8c2,513f2a48fdc9f0358700d4f9,safer,3,0,3
513d7d8dfdc9f03587007202,513e1b62fdc9f03587009470,more beautiful,2,1,3
50f5e8dffdc9f065f0007548,513e1b64fdc9f03587009475,safer,0,3,3
50f5e8e0fdc9f065f0007556,513e5f40fdc9f0358700b1f4,safer,0,3,3
513d6c06fdc9f03587004e75,513d7bcafdc9f03587006ca3,safer,0,3,3
50f5eeadfdc9f065f0008fc2,5140da08fdc9f04926003d26,wealthier,3,0,3
50f5ed6afdc9f065f0008d5b,513d313dfdc9f035870027c2,safer,0,3,3
513d6c56fdc9f03587004f45,5140da15fdc9f04926003d41,more beautiful,3,0,3
513d6c61fdc9f03587004f5f,514149d0fdc9f04926006e7e,livelier,0,3,3
50f55e33fdc9f065f0004b20,513d9c77fdc9f03587007d4f,livelier,0,3,3
50f5e897fdc9f065f00073bc,51421bcdfdc9f049260084c2,livelier,3,0,3
50f46497fdc9f065f00047ee,513cbb46fdc9f03587000eaf,more depressing,0,3,3
50f44857fdc9f065f0003eb8,513d7c16fdc9f03587006d9a,safer,3,0,3
513d6ea5fdc9f0358700533a,51414800fdc9f04926006bb4,safer,0,3,3
513d6e5bfdc9f035870052c8,5141505bfdc9f04926007d14,more boring,1,2,3
513d6dcefdc9f035870051ef,513d9d3bfdc9f03587007fd7,more beautiful,0,3,3
513d6dd7fdc9f035870051fc,51413c22fdc9f04926005aca,wealthier,3,0,3
513d6de0fdc9f0358700520c,513f1194fdc9f0358700c85e,more depressing,3,0,3
513d6c19fdc9f03587004ea8,513f1145fdc9f0358700c7f7,livelier,2,1,3
513d6c2dfdc9f03587004edd,51422cb6fdc9f04926008b6e,livelier,1,2,3
50f44859fdc9f065f0003ed4,5140db59fdc9f04926003ec7,more depressing,3,0,3
50f44857fdc9f065f0003ec0,51414028fdc9f0492600607a,safer,2,1,3
50f44812fdc9f065f0003d67,513d9f21fdc9f03587008643,more beautiful,3,0,3
50f44812fdc9f065f0003d92,51408b9ffdc9f0358700e982,more beautiful,0,3,3
50f5ed66fdc9f065f0008cf1,51422bb2fdc9f04926008a6d,more depressing,3,0,3
50f5ed63fdc9f065f0008cc0,5140d86dfdc9f049260039ef,wealthier,0,3,3
50f44854fdc9f065f0003e65,50f5eb1ffdc9f065f0007fea,safer,1,2,3
50f44855fdc9f065f0003e68,513d6c7ffdc9f03587004fa5,more depressing,0,3,3
513e6ab6fdc9f0358700bf2e,513f31f2fdc9f0358700e01b,livelier,0,3,3
513e6ac0fdc9f0358700bf3b,5141351ffdc9f049260048d3,more boring,0,3,3
50f5ecf0fdc9f065f0008b30,513cb99afdc9f03587000d22,wealthier,1,2,3
50f5ec9efdc9f065f0008ab0,514135ccfdc9f04926004b3d,livelier,3,0,3
513e6cbdfdc9f0358700c1da,513f10befdc9f0358700c748,livelier,2,1,3
50f44867fdc9f065f0003ff0,513f142afdc9f0358700cbe9,livelier,3,0,3
50f4485efdc9f065f0003f62,513d6c26fdc9f03587004ecd,livelier,3,0,3
50f4485efdc9f065f0003f75,513e1a82fdc9f0358700921c,more depressing,0,3,3
513e6f99fdc9f0358700c5c5,51414c00fdc9f0492600720c,safer,3,0,3
513e6ee0fdc9f0358700c4c3,514150b7fdc9f04926007e04,wealthier,3,0,3
50f607cbbeb2fed6f80001f3,514137cdfdc9f04926005062,more beautiful,2,1,3
50f607cdbeb2fed6f8000227,513d9caefdc9f03587007e0d,more depressing,3,0,3
50f607cdbeb2fed6f8000229,513cbf5afdc9f0358700127b,livelier,0,3,3
50f6011ebeb2fed6f8000187,5140993cfdc9f04926000db9,safer,3,0,3
50f44800fdc9f065f0003bf5,50f46487fdc9f065f00046fe,more boring,2,1,3
513f109efdc9f0358700c71a,51422848fdc9f04926008743,more depressing,0,3,3
513d6c86fdc9f03587004fb7,51409de1fdc9f04926001387,livelier,3,0,3
50f5ed99fdc9f065f0008e1c,51421b49fdc9f04926008430,livelier,0,3,3
50f5ed96fdc9f065f0008dd1,51421bb6fdc9f049260084a5,safer,3,0,3
50f5ed96fdc9f065f0008de3,513f2ed1fdc9f0358700dc9f,safer,2,1,3
513d6d7cfdc9f03587005169,513d6e5dfdc9f035870052cb,livelier,3,0,3
513d6db0fdc9f035870051be,513d7a3dfdc9f0358700676e,more depressing,0,3,3
513d6d44fdc9f03587005113,513f2f23fdc9f0358700dd23,livelier,3,0,3
513e6f76fdc9f0358700c592,513f2e87fdc9f0358700dc22,wealthier,0,3,3
513d7d40fdc9f03587007163,513d9becfdc9f03587007b82,safer,0,3,3
513d7d43fdc9f0358700716c,514133f3fdc9f049260044a8,safer,0,3,3
50f5eaa4fdc9f065f0007b69,5185d122fdc9f03fd500109f,safer,0,3,3
513d7e1dfdc9f03587007331,514144c6fdc9f04926006539,more depressing,0,3,3
513d7e5efdc9f035870073bd,513e5cd6fdc9f0358700ac1a,more beautiful,0,3,3
513d7ddefdc9f035870072af,51413a22fdc9f0492600562f,more depressing,3,0,3
513d7de8fdc9f035870072c8,5140ca77fdc9f0492600284a,wealthier,3,0,3
513d7d59fdc9f0358700719e,5140b7e4fdc9f04926001b1e,more depressing,3,0,3
513e5cc8fdc9f0358700abf8,513e644ffdc9f0358700b7f3,more beautiful,0,3,3
513e5cd9fdc9f0358700ac1f,513f3268fdc9f0358700e07d,livelier,3,0,3
50f5e8a7fdc9f065f000744d,514229acfdc9f04926008886,livelier,0,3,3
50f5e8a7fdc9f065f0007453,513d5ec3fdc9f03587003ae7,livelier,0,3,3
50f5e8a5fdc9f065f000742e,513e1efdfdc9f03587009def,safer,3,0,3
50f5e896fdc9f065f00073a7,5141472dfdc9f049260069c9,livelier,3,0,3
513d7d35fdc9f03587007143,513e5f16fdc9f0358700b1bd,more beautiful,3,0,3
513d7d37fdc9f0358700714b,513e5dacfdc9f0358700ae6f,safer,1,2,3
513e233ffdc9f0358700a654,5140d7f9fdc9f04926003906,livelier,0,3,3
513e2348fdc9f0358700a65b,513e65d3fdc9f0358700ba08,livelier,0,3,3
513f107dfdc9f0358700c6ec,5140da97fdc9f04926003dee,livelier,3,0,3
50f44810fdc9f065f0003d24,514146f3fdc9f04926006937,safer,3,0,3
50f44808fdc9f065f0003cbc,513f2c24fdc9f0358700d805,more depressing,0,3,3
50f44802fdc9f065f0003c04,50f563cefdc9f065f0005e81,wealthier,1,2,3
50f447fefdc9f065f0003bae,513e5e90fdc9f0358700b0e6,livelier,0,3,3
50f44800fdc9f065f0003bdc,513e1ce6fdc9f0358700986c,safer,3,0,3
50f55e1cfdc9f065f0004ad6,513d78a2fdc9f03587006221,safer,0,3,3
50f55e1dfdc9f065f0004aeb,50f5e691fdc9f065f0006d88,livelier,3,0,3
50f55e0dfdc9f065f0004a5d,513d9bf8fdc9f03587007bab,wealthier,3,0,3
513d7f63fdc9f035870075d3,51409bbafdc9f049260010e8,livelier,0,3,3
513e5c45fdc9f0358700aa98,51414bb3fdc9f0492600714c,wealthier,0,3,3
513e5cb3fdc9f0358700abbd,51408bd3fdc9f0358700e9ee,more beautiful,2,1,3
513e23bdfdc9f0358700a6e8,5140d7d3fdc9f049260038b6,livelier,3,0,3
513e22fdfdc9f0358700a60f,513f28a6fdc9f0358700d226,safer,0,3,3
50f5e87afdc9f065f00072dc,513d9b61fdc9f035870079c2,more boring,3,0,3
50f5e703fdc9f065f0006f44,513e20f5fdc9f0358700a33d,safer,0,3,3
50f5e708fdc9f065f0006fc5,5142192efdc9f049260081fd,safer,0,3,3
513d9b11fdc9f035870078bd,514150c8fdc9f04926007e2b,livelier,0,3,3
513d9adefdc9f03587007820,514137cefdc9f0492600506a,livelier,0,3,3
513d9ae6fdc9f0358700783b,514094e4fdc9f04926000908,safer,1,2,3
50f55e1afdc9f065f0004aac,513d60cafdc9f03587003d7c,livelier,0,3,3
50f55e1afdc9f065f0004aaf,5140d868fdc9f049260039e4,livelier,3,0,3
513f10b2fdc9f0358700c737,51414d6cfdc9f049260075ad,livelier,3,0,3
513e7007fdc9f0358700c65c,513f2a21fdc9f0358700d4b3,livelier,0,3,3
513e7047fdc9f0358700c6af,51413745fdc9f04926004e68,more beautiful,0,3,3
513f1066fdc9f0358700c6c7,5140b9abfdc9f04926001ec9,more beautiful,3,0,3
50f5e76afdc9f065f000715b,51413864fdc9f049260051ec,safer,0,3,3
513d9b01fdc9f03587007889,51413b06fdc9f04926005864,safer,0,3,3
513d803cfdc9f035870076b8,51413acefdc9f049260057d9,more boring,0,3,3
513d8042fdc9f035870076c1,51409e55fdc9f0492600140f,safer,3,0,3
513d6a8cfdc9f03587004ac3,5140b64ffdc9f049260016a6,livelier,3,0,3
513d6a1dfdc9f03587004973,513f1500fdc9f0358700cd1e,livelier,3,0,3
513d6a25fdc9f0358700498a,5140cc5afdc9f04926002d9d,livelier,3,0,3
513d6a29fdc9f0358700499d,513d7d91fdc9f03587007211,livelier,3,0,3
513d6a2dfdc9f035870049aa,513e1d8ffdc9f03587009a28,livelier,3,0,3
50f60877beb2fed6f8000532,5140b7e5fdc9f04926001b22,livelier,1,2,3
50f60879beb2fed6f800055c,51414cfafdc9f04926007488,more depressing,0,3,3
50f60879beb2fed6f800056a,513e1d1efdc9f03587009902,safer,0,3,3
51413463fdc9f04926004635,51414f73fdc9f04926007ac8,safer,0,3,3
5141337dfdc9f04926004306,51422dc0fdc9f04926008c6e,livelier,0,3,3
50f42ef1fdc9f065f000242e,513d5f11fdc9f03587003b4a,livelier,1,2,3
50f42eedfdc9f065f00023e3,50f563b5fdc9f065f0005de1,safer,0,3,3
50f5eee9fdc9f065f00090c2,5140d88dfdc9f04926003a25,safer,0,3,3
50f5eeecfdc9f065f00090fc,513d6b4cfdc9f03587004caf,livelier,0,3,3
50f5eeecfdc9f065f0009105,513e214ffdc9f0358700a415,safer,3,0,3
50f5eee4fdc9f065f000904a,51421933fdc9f04926008203,wealthier,0,3,3
513f1248fdc9f0358700c94e,51413360fdc9f049260042a3,livelier,3,0,3
513f1121fdc9f0358700c7c8,514217d6fdc9f0492600808c,livelier,2,1,3
50f42eb2fdc9f065f0002395,513d5760fdc9f0358700315e,livelier,0,3,3
5140ba45fdc9f04926001f99,5140d8c4fdc9f04926003aa0,livelier,3,0,3
5140c873fdc9f04926002238,514139bdfdc9f04926005539,safer,3,0,3
5140c874fdc9f0492600223a,51414ec1fdc9f0492600790f,safer,2,1,3
5140b931fdc9f04926001dd1,5140ce02fdc9f04926002fe4,safer,3,0,3
5141344dfdc9f049260045e7,51414715fdc9f0492600698d,livelier,1,2,3
50f44800fdc9f065f0003be3,50f5ecf1fdc9f065f0008b57,safer,3,0,3
50f5ee9bfdc9f065f0008f55,513e61b7fdc9f0358700b5b7,livelier,2,1,3
50f5ee9bfdc9f065f0008f5b,513d7b1bfdc9f03587006a55,safer,0,3,3
50f5eeacfdc9f065f0008fa1,513d7a9bfdc9f035870068c0,wealthier,0,3,3
50f5ee9bfdc9f065f0008f4d,513d2ff1fdc9f035870026bf,wealthier,2,1,3
513f12a2fdc9f0358700c9d8,5185cb8bfdc9f03fd5000b4c,safer,0,3,3
513f1214fdc9f0358700c906,514133b3fdc9f049260043c8,safer,3,0,3
513f1226fdc9f0358700c918,5140d88afdc9f04926003a1d,safer,0,3,3
50f5e76bfdc9f065f00071a6,513e21aefdc9f0358700a485,safer,0,3,3
5140dac2fdc9f04926003e21,51414159fdc9f0492600619c,livelier,0,3,3
5140dafbfdc9f04926003e67,51413b93fdc9f049260059ba,more beautiful,3,0,3
5140db99fdc9f04926003f0d,51414f46fdc9f04926007a5f,livelier,2,1,3
5140dbf1fdc9f04926003f62,51414862fdc9f04926006ca4,more beautiful,3,0,3
50f42c0efdc9f065f00017cf,513e1b07fdc9f0358700936b,livelier,3,0,3
513d6b20fdc9f03587004c49,513e1a5dfdc9f035870091bb,livelier,0,3,3
513d6addfdc9f03587004b94,51413bd5fdc9f04926005a60,more boring,0,3,3
50f55e07fdc9f065f00049e6,51409173fdc9f049260004f6,more beautiful,0,3,3
50f5e76bfdc9f065f0007183,5185ce39fdc9f03fd5000df0,more boring,3,0,3
50f5e768fdc9f065f00070f0,513e6011fdc9f0358700b332,livelier,0,3,3
50f5e768fdc9f065f00070f5,5140d5b9fdc9f0492600353c,more boring,3,0,3
50f5e769fdc9f065f0007116,513d78d4fdc9f035870062d1,more beautiful,0,3,3
50f5e87afdc9f065f00072df,513f29b2fdc9f0358700d3f9,safer,1,2,3
50f5e87dfdc9f065f0007326,513e5d58fdc9f0358700ad84,safer,0,3,3
50f5e76bfdc9f065f000719d,5140b725fdc9f0492600190a,safer,0,3,3
513e21cafdc9f0358700a4a1,5140c9a6fdc9f049260025cd,livelier,0,3,3
513e212dfdc9f0358700a3e0,5140ce23fdc9f04926003005,safer,3,0,3
513e217dfdc9f0358700a448,5140c859fdc9f049260021ea,safer,0,3,3
50f5e760fdc9f065f00070aa,513d6039fdc9f03587003cbe,livelier,0,3,3
50f5e768fdc9f065f00070ea,51414f01fdc9f049260079ad,more beautiful,3,0,3
50f55e0dfdc9f065f0004a69,50f5eb64fdc9f065f000826d,safer,0,3,3
50f55e1afdc9f065f0004a9d,51422791fdc9f04926008691,safer,0,3,3
50f55e1afdc9f065f0004aa1,513f2c02fdc9f0358700d7cc,livelier,1,2,3
513d6ae7fdc9f03587004bb2,513d7accfdc9f03587006958,more beautiful,0,3,3
50f607dcbeb2fed6f800033b,51414edffdc9f04926007958,more boring,0,3,3
50f607d6beb2fed6f80002d9,51414ccefdc9f04926007411,wealthier,2,1,3
50f55e52fdc9f065f0004bc0,5140d709fdc9f04926003728,safer,2,1,3
50f55e54fdc9f065f0004be8,513d9f12fdc9f03587008609,wealthier,3,0,3
50f55e08fdc9f065f00049f8,51413498fdc9f049260046f5,livelier,3,0,3
50f55e0bfdc9f065f0004a34,5141479ffdc9f04926006ac3,safer,3,0,3
513e2285fdc9f0358700a576,513e62e5fdc9f0358700b773,safer,3,0,3
50f447dafdc9f065f0003b64,5140b717fdc9f049260018e0,livelier,3,0,3
513d6971fdc9f03587004722,513d7a4efdc9f035870067a8,more depressing,0,3,3
513d697afdc9f03587004745,51414fc8fdc9f04926007b9e,safer,3,0,3
513d694bfdc9f03587004697,513e1deffdc9f03587009b1a,livelier,3,0,3
513d694efdc9f035870046a0,5140c9d0fdc9f0492600264d,livelier,2,1,3
513d694ffdc9f035870046a5,513d6a5dfdc9f03587004a4a,livelier,0,3,3
50f60b93beb2fed9100000bf,513cb650fdc9f03587000a1c,more depressing,0,3,3
50f60b96beb2fed9100000cd,51413b86fdc9f0492600599e,safer,3,0,3
50f447d3fdc9f065f0003a8f,51414f1dfdc9f049260079f9,safer,0,3,3
50f447d8fdc9f065f0003af5,513d9c83fdc9f03587007d7a,safer,0,3,3
50f447d2fdc9f065f0003a61,5140b756fdc9f04926001995,livelier,0,3,3
50f60b88beb2fed910000006,5185d09dfdc9f03fd5001032,livelier,3,0,3
50f60872beb2fed6f80004d7,513cbb30fdc9f03587000e9a,more beautiful,3,0,3
513f2917fdc9f0358700d2e6,5140b670fdc9f049260016fe,more boring,0,3,3
513f1538fdc9f0358700cd62,5140d8a0fdc9f04926003a52,more beautiful,3,0,3
513f13e1fdc9f0358700cb80,513f2d7cfdc9f0358700da50,more beautiful,0,3,3
50f6086fbeb2fed6f800049e,513d6cfdfdc9f0358700509d,safer,3,0,3
513f133afdc9f0358700caa3,513f2cb0fdc9f0358700d8ef,safer,0,3,3
50f42de0fdc9f065f000228e,513cbeaefdc9f035870011d9,livelier,3,0,3
50f42de0fdc9f065f0002296,513f304efdc9f0358700deb8,safer,3,0,3
50f42de0fdc9f065f0002299,51413623fdc9f04926004bf1,more beautiful,3,0,3
50f42eaafdc9f065f00022c4,50f5ecf1fdc9f065f0008b57,safer,3,0,3
50f447dbfdc9f065f0003b7c,513d7adcfdc9f0358700698c,safer,3,0,3
50f447dbfdc9f065f0003b84,50f5640efdc9f065f000605d,livelier,3,0,3
513f119efdc9f0358700c86e,513f2edefdc9f0358700dcb4,safer,0,3,3
5140dc00fdc9f04926003f74,51415074fdc9f04926007d5a,livelier,0,3,3
51413332fdc9f0492600420c,5141428cfdc9f049260062e7,more beautiful,0,3,3
51413344fdc9f04926004243,5185cce3fdc9f03fd5000ca0,safer,0,3,3
5140daaefdc9f04926003e0a,51413769fdc9f04926004ee4,more beautiful,0,3,3
50f42ef2fdc9f065f000246b,50f44856fdc9f065f0003e96,safer,3,0,3
50f42efcfdc9f065f0002488,50f607d8beb2fed6f80002fe,wealthier,0,3,3
50f6086ebeb2fed6f8000479,514146a6fdc9f04926006874,livelier,3,0,3
513d699efdc9f035870047bf,51413351fdc9f0492600426f,safer,3,0,3
50f60b97beb2fed9100000ea,513d6a1dfdc9f03587004973,safer,3,0,3
50f60b97beb2fed9100000f5,513d9cd1fdc9f03587007e81,livelier,3,0,3
50f60b98beb2fed91000010a,513ccbc6fdc9f03587001d1b,more depressing,0,3,3
50f6086abeb2fed6f8000433,5140c9dffdc9f04926002678,safer,0,3,3
513d69f9fdc9f035870048f3,5141489cfdc9f04926006d0e,livelier,0,3,3
513d6a09fdc9f03587004927,5140da25fdc9f04926003d64,safer,3,0,3
513d69eafdc9f035870048c5,513f3237fdc9f0358700e055,safer,2,1,3
50f55e6dfdc9f065f0004c6b,513d59a7fdc9f035870033a6,safer,3,0,3
50f55e56fdc9f065f0004c1f,513d9b57fdc9f035870079a8,safer,3,0,3
50f55e6afdc9f065f0004c21,50f5e6cafdc9f065f0006e4e,safer,2,1,3
50f55e6bfdc9f065f0004c46,51414169fdc9f049260061b3,wealthier,3,0,3
50f55e50fdc9f065f0004ba8,513d5eb9fdc9f03587003ad9,safer,3,0,3
50f60b90beb2fed91000007e,513d6994fdc9f0358700479d,more beautiful,0,3,3
50f60b8cbeb2fed910000049,513e1e5afdc9f03587009c3b,more beautiful,2,1,3
513d69bbfdc9f0358700482a,513d7e25fdc9f0358700733e,safer,3,0,3
513d9c8cfdc9f03587007d97,51422a08fdc9f049260088ce,more beautiful,3,0,3
513d9c88fdc9f03587007d8c,513e1eb0fdc9f03587009d22,more beautiful,3,0,3
513d9c2efdc9f03587007c5a,513d9ffafdc9f0358700887f,livelier,1,2,3
50f55e54fdc9f065f0004bed,50f5ed9bfdc9f065f0008e5a,safer,3,0,3
50f5e75cfdc9f065f0007070,513cd08efdc9f03587001e05,livelier,3,0,3
50f5e75cfdc9f065f0007076,5140d052fdc9f0492600321b,safer,3,0,3
50f5e75cfdc9f065f000707a,51414692fdc9f0492600684b,safer,1,2,3
50f5e75efdc9f065f0007095,513cd93cfdc9f03587001fd5,safer,0,3,3
50f60b8ebeb2fed910000078,513cb85efdc9f03587000bf3,more depressing,0,3,3
513d9bf3fdc9f03587007b9c,5140b8e1fdc9f04926001d34,more beautiful,3,0,3
50f5e6fdfdc9f065f0006ea0,513f1434fdc9f0358700cbf5,livelier,1,2,3
50f5e6fefdc9f065f0006ec0,50f5e903fdc9f065f0007654,wealthier,0,3,3
50f5e6fefdc9f065f0006ec5,513d7bb4fdc9f03587006c5b,more depressing,3,0,3
50f5e6fffdc9f065f0006edd,51414ecdfdc9f0492600792b,livelier,0,3,3
50f5e6fbfdc9f065f0006e77,50f5eae9fdc9f065f0007df9,more beautiful,0,3,3
50f5e6fcfdc9f065f0006e88,513d6d7dfdc9f0358700516b,livelier,0,3,3
513d6901fdc9f03587004591,5140ca8cfdc9f0492600288b,safer,0,3,3
50f6145bbeb2fed91000072f,513e612dfdc9f0358700b4ef,wealthier,3,0,3
50f60e76beb2fed91000069c,514089cffdc9f0358700e5c7,livelier,0,3,3
50f60e77beb2fed9100006a4,513f12fcfdc9f0358700ca4f,livelier,0,3,3
50f61676beb2fed9100008cf,51413554fdc9f04926004990,more beautiful,3,0,3
50f61676beb2fed9100008d4,513d9f09fdc9f035870085ee,more beautiful,0,3,3
50f61679beb2fed9100008e3,51413395fdc9f04926004366,more beautiful,0,3,3
513d68bdfdc9f035870044a5,5140c95ffdc9f049260024fa,livelier,1,2,3
50f44509fdc9f065f00033f8,51408f84fdc9f049260000ec,more boring,1,2,3
50f4450afdc9f065f000340c,513e1b06fdc9f03587009369,livelier,3,0,3
50f447cefdc9f065f0003a1a,513e1ef8fdc9f03587009de1,livelier,3,0,3
513d6958fdc9f035870046c4,51414d78fdc9f049260075c9,more depressing,3,0,3
513d68dffdc9f03587004516,513f2909fdc9f0358700d2cf,livelier,0,3,3
513d68e0fdc9f03587004518,5140d9b9fdc9f04926003c7c,safer,0,3,3
513d68ebfdc9f03587004542,5140b8f6fdc9f04926001d59,more boring,3,0,3
513d68fdfdc9f03587004581,5141518bfdc9f04926007fba,safer,0,3,3
50f447cdfdc9f065f00039fb,50f55e33fdc9f065f0004b19,livelier,1,2,3
50f447cdfdc9f065f0003a08,514138fdfdc9f0492600535c,safer,2,1,3
50f445aefdc9f065f000359a,50f5e56afdc9f065f00068b6,more depressing,3,0,3
50f445b0fdc9f065f00035e7,5141483bfdc9f04926006c41,safer,0,3,3
50f60c52beb2fed9100002e6,513d6877fdc9f035870043a4,wealthier,3,0,3
50f60c54beb2fed910000305,51414d8cfdc9f04926007604,safer,3,0,3
50f44508fdc9f065f00033e1,51414311fdc9f0492600636b,safer,2,1,3
50f44509fdc9f065f00033ed,513da041fdc9f03587008923,more boring,0,3,3
513d69b3fdc9f0358700480e,5140da2cfdc9f04926003d75,more depressing,3,0,3
50f445adfdc9f065f000358d,50f5635ffdc9f065f0005ccc,safer,0,3,3
513f294dfdc9f0358700d338,513f2a6efdc9f0358700d532,livelier,0,3,3
513f2979fdc9f0358700d390,5140b833fdc9f04926001bca,more beautiful,0,3,3
513f28ebfdc9f0358700d295,5140cd5ffdc9f04926002f42,safer,0,3,3
50f60c4abeb2fed910000244,513f2f2bfdc9f0358700dd2f,more beautiful,3,0,3
50f447cefdc9f065f0003a27,514089d3fdc9f0358700e5d0,wealthier,0,3,3
50f447ccfdc9f065f00039da,513e5cb1fdc9f0358700abbb,more beautiful,3,0,3
513d68c0fdc9f035870044ae,514150adfdc9f04926007dee,more beautiful,3,0,3
513d68c5fdc9f035870044c0,513e1f7afdc9f03587009f39,safer,3,0,3
513d68affdc9f0358700446d,51422a1ffdc9f049260088eb,livelier,0,3,3
50f60c4dbeb2fed91000027c,514133fffdc9f049260044d1,more depressing,0,3,3
50f60c4fbeb2fed9100002af,51408accfdc9f0358700e7d1,wealthier,0,3,3
50f60c50beb2fed9100002bf,513d362afdc9f03587002b6a,livelier,3,0,3
50f60c47beb2fed910000208,513cc7e4fdc9f03587001aaf,wealthier,1,2,3
50f44562fdc9f065f000348f,5140d246fdc9f049260032b4,safer,0,3,3
513d9b3ffdc9f03587007950,51413381fdc9f04926004317,more beautiful,0,3,3
50f5e6c6fdc9f065f0006dfa,513da099fdc9f035870089e3,safer,2,1,3
50f5e6c9fdc9f065f0006e08,51421b79fdc9f0492600845e,safer,3,0,3
50f5e6c9fdc9f065f0006e13,513cc364fdc9f03587001679,more depressing,3,0,3
50f5e6cafdc9f065f0006e3a,513f29fbfdc9f0358700d471,livelier,0,3,3
50f6145fbeb2fed910000769,513cc8d8fdc9f03587001b98,livelier,3,0,3
50f60c45beb2fed9100001d1,513d6a30fdc9f035870049b2,wealthier,0,3,3
513d68bffdc9f035870044aa,513d9eadfdc9f035870084b0,more beautiful,3,0,3
50f55e37fdc9f065f0004b7a,513d57aefdc9f035870031db,safer,0,3,3
50f55e38fdc9f065f0004b8b,50f60c51beb2fed9100002da,safer,0,3,3
50f55e9dfdc9f065f0004dc6,513d6aaffdc9f03587004b24,livelier,0,3,3
50f55eaffdc9f065f0004e00,5140cc30fdc9f04926002d3a,more depressing,3,0,3
50f55eb0fdc9f065f0004e08,51409c5efdc9f049260011ad,safer,2,1,3
513d9bb4fdc9f03587007acc,514147e5fdc9f04926006b76,livelier,3,0,3
513d9b51fdc9f03587007997,51408a61fdc9f0358700e6f7,safer,0,3,3
513d9b74fdc9f035870079fc,514135c1fdc9f04926004b13,livelier,3,0,3
513d6883fdc9f035870043d0,51414512fdc9f0492600658a,more depressing,3,0,3
513d6889fdc9f035870043e7,513d6956fdc9f035870046be,livelier,1,2,3
50f6145ebeb2fed91000074a,5140b95dfdc9f04926001e30,safer,0,3,3
50f55e7bfdc9f065f0004ce0,513d9f31fdc9f03587008675,more boring,0,3,3
50f55e7efdc9f065f0004d20,513d7c47fdc9f03587006e41,more beautiful,3,0,3
50f55e79fdc9f065f0004cbe,513d5b47fdc9f035870034f5,safer,0,3,3
513e2044fdc9f0358700a164,513e628bfdc9f0358700b6ea,livelier,0,3,3
513e2055fdc9f0358700a191,51413d5ffdc9f04926005d0f,more depressing,0,3,3
50f6167ebeb2fed91000093c,51414f33fdc9f04926007a2c,livelier,3,0,3
513d61e2fdc9f03587003ed5,51415169fdc9f04926007f95,wealthier,3,0,3
5140d533fdc9f04926003443,51414bb2fdc9f04926007148,livelier,0,3,3
5140d041fdc9f0492600320a,51414785fdc9f04926006a89,livelier,3,0,3
5140d061fdc9f0492600322f,51415152fdc9f04926007f6e,safer,3,0,3
5140d26afdc9f049260032d4,5140d8adfdc9f04926003a71,livelier,1,2,3
5140cf4dfdc9f04926003125,51421b49fdc9f04926008431,safer,0,3,3
50f42c69fdc9f065f0001bc1,513d6904fdc9f0358700459c,more boring,3,0,3
50f61463beb2fed9100007b7,51414e6ffdc9f0492600784d,livelier,2,1,3
513d60d5fdc9f03587003d87,51422ac9fdc9f04926008996,livelier,3,0,3
513d60e7fdc9f03587003d97,513d6c2cfdc9f03587004ed9,safer,3,0,3
513d6154fdc9f03587003e21,51409d10fdc9f04926001282,livelier,3,0,3
513d6095fdc9f03587003d38,5141425afdc9f049260062b3,safer,3,0,3
513d60a3fdc9f03587003d4a,51409d17fdc9f04926001289,wealthier,0,3,3
50f61681beb2fed910000969,5185cb3cfdc9f03fd5000aff,wealthier,3,0,3
51392458818ede1296000fe9,51414448fdc9f049260064b0,safer,0,3,3
50f43bacfdc9f065f0003304,50f56431fdc9f065f0006173,livelier,0,3,3
513f2b8efdc9f0358700d707,5140b884fdc9f04926001c73,safer,3,0,3
513f2baefdc9f0358700d73e,51409b61fdc9f04926001079,wealthier,0,3,3
50f61670beb2fed910000856,51421a05fdc9f049260082d0,more boring,0,3,3
50f61673beb2fed910000883,513e1ebefdc9f03587009d45,more depressing,3,0,3
50f6166ebeb2fed910000832,513d67d6fdc9f03587004196,safer,3,0,3
50f61670beb2fed910000855,513e61f8fdc9f0358700b619,safer,3,0,3
50f61463beb2fed9100007b7,513e6fe2fdc9f0358700c627,livelier,3,0,3
50f44563fdc9f065f000349c,5185d397fdc9f03fd50012f3,more depressing,3,0,3
50f44566fdc9f065f00034ce,5141346bfdc9f04926004656,safer,0,3,3
513f2b2ffdc9f0358700d66a,51409d18fdc9f0492600128b,livelier,0,3,3
513f2b46fdc9f0358700d694,514133a3fdc9f04926004396,more boring,0,3,3
513f2b76fdc9f0358700d6da,51414e3ffdc9f049260077c5,more depressing,3,0,3
513f2a89fdc9f0358700d559,51414fbafdc9f04926007b7d,livelier,3,0,3
50f44568fdc9f065f00034fe,513cb79cfdc9f03587000b45,livelier,0,3,3
50f61464beb2fed9100007c4,51414d57fdc9f04926007579,safer,0,3,3
50f44503fdc9f065f0003384,51409824fdc9f04926000c3e,more boring,1,2,3
50f43baefdc9f065f0003331,513d78fdfdc9f03587006359,safer,3,0,3
50f43baffdc9f065f0003344,5140d7c7fdc9f049260038a1,more beautiful,0,3,3
51392776818ede12960010bf,513d2f66fdc9f0358700264f,more beautiful,0,3,3
5139278e818ede12960010c6,514091e4fdc9f049260005da,livelier,0,3,3
513f2d5afdc9f0358700da0b,514090e1fdc9f049260003be,livelier,0,3,3
513f2d7bfdc9f0358700da4f,51414ccefdc9f04926007410,more boring,3,0,3
513f2d83fdc9f0358700da5c,514146ccfdc9f049260068d5,wealthier,0,3,3
513d616ffdc9f03587003e41,513f1388fdc9f0358700cb09,more beautiful,0,3,3
513d678efdc9f035870040e3,513e700afdc9f0358700c661,safer,0,3,3
513924c8818ede1296001009,5185cb05fdc9f03fd5000acb,livelier,0,3,3
513d67f6fdc9f035870041e7,513d9be2fdc9f03587007b5f,safer,3,0,3
513d67b6fdc9f03587004147,513d7e1afdc9f0358700732c,livelier,3,0,3
513d6213fdc9f03587003f1b,513d7821fdc9f0358700606e,livelier,0,3,3
513d6785fdc9f035870040cb,51421b83fdc9f0492600846c,safer,0,3,3
50f44502fdc9f065f0003379,51408f39fdc9f04926000052,livelier,1,2,3
50f5e685fdc9f065f0006cab,513d69d5fdc9f03587004886,wealthier,3,0,3
50f5e686fdc9f065f0006cbf,5140c94efdc9f049260024c6,more beautiful,0,3,3
50f5e689fdc9f065f0006cfe,513cbd62fdc9f0358700109e,livelier,3,0,3
50f5e689fdc9f065f0006d03,513d6834fdc9f035870042b7,safer,1,2,3
50f5e649fdc9f065f0006c71,513d7b3ffdc9f03587006acf,livelier,0,3,3
513e2058fdc9f0358700a19a,513e5dd6fdc9f0358700aedf,wealthier,0,3,3
513e206ffdc9f0358700a1db,513e5fd5fdc9f0358700b2d5,livelier,0,3,3
513d6166fdc9f03587003e32,513e20bbfdc9f0358700a2a0,more depressing,3,0,3
50f42c6bfdc9f065f0001be9,50f433d1fdc9f065f0002703,more beautiful,3,0,3
50f5e640fdc9f065f0006ba0,5140b7c4fdc9f04926001ad1,wealthier,3,0,3
50f5e640fdc9f065f0006bb9,513cbceafdc9f0358700102b,safer,3,0,3
50f5e640fdc9f065f0006bc4,513f2e89fdc9f0358700dc27,wealthier,1,2,3
50f5e5e0fdc9f065f0006b2e,5142282ffdc9f0492600872c,more boring,3,0,3
5140d6ecfdc9f049260036ee,514137ebfdc9f049260050da,safer,0,3,3
5140d719fdc9f0492600374b,514147fafdc9f04926006bab,more boring,0,3,3
50f5e6c4fdc9f065f0006dd4,513e5cb3fdc9f0358700abbd,wealthier,3,0,3
513f2daafdc9f0358700da99,5140c99ffdc9f049260025b9,safer,0,3,3
513f2db4fdc9f0358700daaf,51413483fdc9f049260046a4,safer,1,2,3
513f2dc6fdc9f0358700dacf,51414ca3fdc9f049260073a7,safer,3,0,3
51392cf0818ede1296001237,513e5d76fdc9f0358700addb,livelier,0,3,3
51392a2c818ede1296001177,51409d3cfdc9f049260012bd,livelier,3,0,3
51392af2818ede12960011b3,51413a9efdc9f04926005762,more beautiful,3,0,3
51392bf0818ede12960011f3,51409976fdc9f04926000e06,safer,0,3,3
51392908818ede1296001128,51409e47fdc9f04926001402,livelier,3,0,3
50f55e37fdc9f065f0004b76,5140ca9ffdc9f049260028c6,more depressing,0,3,3
50f42c53fdc9f065f0001b10,51413579fdc9f04926004a00,more boring,3,0,3
50f5e63afdc9f065f0006b46,513e1fb0fdc9f03587009fd3,safer,3,0,3
50f5e63dfdc9f065f0006b8a,51414698fdc9f04926006859,livelier,3,0,3
50f44502fdc9f065f0003364,50f60878beb2fed6f8000543,livelier,0,3,3
513f2ddcfdc9f0358700daf5,5185cc9ffdc9f03fd5000c57,livelier,3,0,3
513f2e47fdc9f0358700dba7,513f2fc6fdc9f0358700de2e,more beautiful,0,3,3
513f2da6fdc9f0358700da8e,5185cf3bfdc9f03fd5000ef0,more boring,0,3,3
513e2009fdc9f0358700a0c6,51415108fdc9f04926007ebf,more boring,3,0,3
50f5609afdc9f065f000527f,5185d302fdc9f03fd500125c,more depressing,0,3,3
50f5609afdc9f065f0005288,514143a6fdc9f04926006412,more boring,3,0,3
50f5e5d9fdc9f065f0006ac1,513d3598fdc9f03587002afb,more boring,3,0,3
50f5e5dcfdc9f065f0006af9,513d788ffdc9f035870061e4,more beautiful,0,3,3
50f5e5defdc9f065f0006b10,513cc235fdc9f0358700154a,wealthier,2,1,3
50f5e6c2fdc9f065f0006d9e,513e1b75fdc9f035870094a0,safer,0,3,3
50f5e6c3fdc9f065f0006dac,513ccd5cfdc9f03587001d70,safer,3,0,3
513f2cbefdc9f0358700d90c,5140d222fdc9f04926003290,wealthier,3,0,3
5140cb6efdc9f04926002b5e,514139a5fdc9f049260054fb,livelier,2,1,3
50f5608dfdc9f065f00051e3,514217e2fdc9f04926008099,more beautiful,0,3,3
50f56091fdc9f065f000520f,513d7de5fdc9f035870072c1,livelier,0,3,3
50f5609afdc9f065f0005266,5141382afdc9f04926005168,safer,2,1,3
50f56089fdc9f065f00051a8,513e6f63fdc9f0358700c578,more beautiful,3,0,3
50f5e585fdc9f065f000696a,50f5ec33fdc9f065f00087bc,safer,0,3,3
513e1ff0fdc9f0358700a086,51414d1dfdc9f049260074dd,safer,3,0,3
5140cbfafdc9f04926002cb9,514228abfdc9f049260087a1,safer,0,3,3
5140cc09fdc9f04926002cd9,5140d843fdc9f04926003999,livelier,3,0,3
5140cb62fdc9f04926002b3a,51413aa6fdc9f04926005775,more depressing,3,0,3
513d5edbfdc9f03587003b09,513e1cdcfdc9f03587009851,safer,0,3,3
513cb302fdc9f035870006e3,513f28defdc9f0358700d281,safer,2,1,3
513cb30afdc9f035870006ec,513f3062fdc9f0358700dec6,more depressing,0,3,3
513d5f85fdc9f03587003bda,51413a6cfdc9f049260056de,more boring,0,3,3
513927c0818ede12960010d1,513e5f00fdc9f0358700b19c,more beautiful,0,3,3
50f5e565fdc9f065f000682d,513f2a1cfdc9f0358700d4ab,livelier,3,0,3
50f5e569fdc9f065f00068a0,50f5ec9cfdc9f065f0008a7a,safer,0,3,3
50f5e564fdc9f065f000681d,513da068fdc9f03587008983,safer,2,1,3
50f5e565fdc9f065f0006820,5140c9a4fdc9f049260025c7,safer,0,3,3
50f5e56afdc9f065f00068b8,51415077fdc9f04926007d62,livelier,3,0,3
513d9cf3fdc9f03587007ef8,513f3060fdc9f0358700dec5,livelier,3,0,3
513d9d10fdc9f03587007f4e,513e1cc5fdc9f0358700980f,livelier,0,3,3
513d9ce9fdc9f03587007ed7,51422d7ffdc9f04926008c2a,more boring,0,3,3
50f5e562fdc9f065f00067d3,51422d19fdc9f04926008bcd,safer,3,0,3
50f5e562fdc9f065f00067d6,5140cc3cfdc9f04926002d52,livelier,3,0,3
50f5e528fdc9f065f0006733,50f5e872fdc9f065f00072db,more beautiful,2,1,3
513d9dc5fdc9f035870081b5,5185d396fdc9f03fd50012f2,livelier,2,1,3
513d9dcefdc9f035870081d1,5140c9cbfdc9f0492600263a,more beautiful,0,3,3
513d9dd6fdc9f035870081e9,51414f2bfdc9f04926007a1b,more beautiful,3,0,3
50f56450fdc9f065f0006293,513e1e1dfdc9f03587009b99,livelier,0,3,3
50f5e400fdc9f065f000660b,50f5eaadfdc9f065f0007c06,livelier,0,3,3
51392956818ede129600113f,5140d909fdc9f04926003b1a,livelier,3,0,3
51392a0a818ede1296001170,51413ac5fdc9f049260057c3,safer,0,3,3
513cb8bafdc9f03587000c51,514098a8fdc9f04926000cf0,livelier,3,0,3
513cb7f8fdc9f03587000b94,513f10e0fdc9f0358700c776,safer,0,3,3
513cb86cfdc9f03587000c02,513d9d0afdc9f03587007f3f,more depressing,1,2,3
513d5fc0fdc9f03587003c2a,5140b6c6fdc9f04926001803,livelier,3,0,3
513d5f57fdc9f03587003ba2,513e6af0fdc9f0358700bf7a,livelier,3,0,3
513d9d4ffdc9f03587008017,513f2b3dfdc9f0358700d685,livelier,3,0,3
513cb9e8fdc9f03587000d69,51408f50fdc9f04926000086,wealthier,0,3,3
514135aafdc9f04926004ab9,514142c2fdc9f0492600631a,more depressing,0,3,3
5141347ffdc9f0492600469a,51414550fdc9f049260065cc,more depressing,3,0,3
51413567fdc9f049260049ca,514149d6fdc9f04926006e8f,safer,3,0,3
50f42bbafdc9f065f00016c7,50f563b6fdc9f065f0005df9,livelier,3,0,3
513e1ec9fdc9f03587009d65,51422851fdc9f0492600874b,more depressing,0,3,3
513d9dd9fdc9f035870081f7,514090f9fdc9f049260003ee,livelier,3,0,3
50f5e527fdc9f065f00066cf,513d6924fdc9f03587004616,more boring,3,0,3
513f2f6dfdc9f0358700dd9b,51421960fdc9f0492600822e,safer,3,0,3
513cb78afdc9f03587000b34,513cc198fdc9f035870014b7,more depressing,3,0,3
513cb7aefdc9f03587000b55,514228b3fdc9f049260087a9,livelier,0,3,3
513cb7c8fdc9f03587000b6a,513d353efdc9f03587002ab3,safer,2,1,3
513cb666fdc9f03587000a30,513d5b58fdc9f03587003513,safer,3,0,3
513cb6c6fdc9f03587000a8a,51414691fdc9f04926006846,safer,0,3,3
513cba4efdc9f03587000dc8,513e1c21fdc9f03587009666,more beautiful,3,0,3
513cbab0fdc9f03587000e19,513e1d52fdc9f03587009989,livelier,3,0,3
513f2eb6fdc9f0358700dc74,51414d5cfdc9f04926007586,more beautiful,0,3,3
50f43baafdc9f065f00032d1,5185cc2cfdc9f03fd5000beb,more beautiful,0,3,3
513d5e9dfdc9f03587003ab4,51409a87fdc9f04926000f68,safer,2,1,3
513f3027fdc9f0358700de99,514147c5fdc9f04926006b22,wealthier,3,0,3
513f302cfdc9f0358700de9e,514147d4fdc9f04926006b49,safer,2,1,3
513f308cfdc9f0358700def1,5140d38cfdc9f049260033ea,safer,3,0,3
513f2ec1fdc9f0358700dc89,514094d4fdc9f049260008f4,more depressing,3,0,3
513f2f1dfdc9f0358700dd16,5140b817fdc9f04926001b90,wealthier,0,3,3
513cb5effdc9f035870009b9,5140b76dfdc9f049260019d4,safer,3,0,3
513cb5fcfdc9f035870009c7,513cbd30fdc9f0358700106b,wealthier,1,2,3
513cb350fdc9f0358700072c,5140b909fdc9f04926001d7d,more beautiful,0,3,3
50f43ba6fdc9f065f000328b,513d3626fdc9f03587002b67,livelier,0,3,3
513d5ea3fdc9f03587003abc,51409564fdc9f04926000983,more boring,0,3,3
513d5e33fdc9f03587003a1e,51413450fdc9f049260045f7,safer,0,3,3
513f2e9bfdc9f0358700dc46,5140b6f6fdc9f04926001883,safer,3,0,3
513f2ea4fdc9f0358700dc56,51408bf4fdc9f0358700ea26,livelier,2,1,3
513d5e45fdc9f03587003a3f,5185d416fdc9f03fd5001373,more depressing,3,0,3
513d5e62fdc9f03587003a66,51414d9dfdc9f04926007635,safer,3,0,3
513d5e1cfdc9f035870039f1,5140cef2fdc9f049260030c5,livelier,0,3,3
513d5e27fdc9f03587003a09,513e60d7fdc9f0358700b468,safer,3,0,3
513d5dbafdc9f03587003947,51414df9fdc9f0492600771c,more depressing,3,0,3
50f43b70fdc9f065f00030cc,513d5773fdc9f0358700317b,more boring,0,3,3
50f43b73fdc9f065f00030f7,513f2a64fdc9f0358700d525,safer,2,1,3
513cbd42fdc9f0358700107f,5140b763fdc9f049260019b8,more boring,0,3,3
513d9d89fdc9f035870080e1,513f2a9dfdc9f0358700d57a,more depressing,0,3,3
513d9d99fdc9f03587008118,5141390afdc9f04926005380,livelier,3,0,3
513d9d9efdc9f0358700812b,513e5da8fdc9f0358700ae65,safer,3,0,3
513d9d68fdc9f0358700806c,513e22cefdc9f0358700a5d2,livelier,3,0,3
50f42bbbfdc9f065f00016d6,513f151ffdc9f0358700cd44,safer,2,1,3
513cbafafdc9f03587000e66,5140ca51fdc9f049260027d4,more beautiful,0,3,3
51413773fdc9f04926004f0a,5141451dfdc9f04926006596,more boring,0,3,3
514135d1fdc9f04926004b48,5141448efdc9f049260064fe,safer,3,0,3
513d9e07fdc9f03587008292,51421ac7fdc9f049260083a6,livelier,3,0,3
513d9dd7fdc9f035870081ef,513e6001fdc9f0358700b319,safer,3,0,3
513d9d59fdc9f0358700803a,5185d12efdc9f03fd50010af,safer,0,3,3
50f5e5cefdc9f065f0006a4d,513f2ac8fdc9f0358700d5c4,wealthier,3,0,3
50f5e5d0fdc9f065f0006a63,513d35f4fdc9f03587002b45,safer,0,3,3
50f5e58dfdc9f065f00069c0,513d6021fdc9f03587003c9d,safer,3,0,3
50f5e58efdc9f065f00069ec,513e5e5efdc9f0358700b052,livelier,0,3,3
50f5e56ffdc9f065f000692c,513d6b0efdc9f03587004c19,wealthier,3,0,3
50f5e51dfdc9f065f0006668,514139affdc9f04926005518,more boring,0,3,3
5140cad7fdc9f04926002977,5140cf24fdc9f049260030fb,livelier,0,3,3
50f42c81fdc9f065f0001e30,513cc7dafdc9f03587001aa7,safer,3,0,3
50f5642cfdc9f065f0006109,513cb322fdc9f03587000703,livelier,0,3,3
513d9e81fdc9f03587008422,5140c8d2fdc9f04926002358,safer,3,0,3
513d9e86fdc9f03587008432,513e64ccfdc9f0358700b8a4,safer,3,0,3
513d9e95fdc9f03587008461,51414bf5fdc9f049260071ee,livelier,0,3,3
513d9ea0fdc9f03587008489,513e1bbbfdc9f03587009553,safer,0,3,3
50f42c7ffdc9f065f0001da3,513e1c61fdc9f03587009718,safer,0,3,3
513e1fbefdc9f03587009ff9,5140da1dfdc9f04926003d52,safer,0,3,3
513e1f54fdc9f03587009ed2,513f320cfdc9f0358700e030,more boring,3,0,3
50f43b70fdc9f065f00030c5,513cbd2cfdc9f03587001067,more boring,3,0,3
50f43b70fdc9f065f00030c8,51414ffbfdc9f04926007c23,safer,3,0,3
50f439f9fdc9f065f0002e33,513e6b06fdc9f0358700bf93,safer,3,0,3
50f43aa5fdc9f065f0002e63,50f5ec1dfdc9f065f0008778,safer,2,1,3
50f43aa5fdc9f065f0002e65,5140cb8afdc9f04926002bb0,wealthier,3,0,3
513d9eb3fdc9f035870084c3,51414448fdc9f049260064b1,more boring,1,2,3
513d9eb7fdc9f035870084ce,513e6df7fdc9f0358700c38a,safer,3,0,3
513d9ec3fdc9f035870084f4,513e1b5ffdc9f03587009466,livelier,2,1,3
50f5611cfdc9f065f00053f7,513e2365fdc9f0358700a681,livelier,3,0,3
513e1ee7fdc9f03587009db8,51414ea9fdc9f049260078e0,wealthier,0,3,3
50f5e400fdc9f065f0006612,513d78e8fdc9f0358700631a,wealthier,3,0,3
50f5e51afdc9f065f0006638,51413a32fdc9f04926005657,livelier,0,3,3
50f42c80fdc9f065f0001e03,513d9f04fdc9f035870085dc,more beautiful,3,0,3
50f5611cfdc9f065f00053fa,5140d80ffdc9f04926003931,more boring,0,3,3
50f560f4fdc9f065f0005371,513e20d1fdc9f0358700a2d8,livelier,0,3,3
50f560f4fdc9f065f0005371,5140d541fdc9f04926003457,livelier,2,1,3
50f560f4fdc9f065f0005372,50f61670beb2fed91000085f,livelier,3,0,3
50f560f9fdc9f065f000538c,5141460efdc9f0492600670f,livelier,0,3,3
50f560f2fdc9f065f0005352,51408fa9fdc9f04926000130,more depressing,0,3,3
513d9ee3fdc9f03587008568,513e6a5ffdc9f0358700beb0,livelier,3,0,3
513d9ea5fdc9f0358700849b,51409b02fdc9f04926000ffb,safer,0,3,3
513cbd4efdc9f0358700108a,51414dc0fdc9f04926007690,more boring,0,3,3
513cbd7afdc9f035870010b3,513d7a4ffdc9f035870067ad,more beautiful,0,3,3
513cbd90fdc9f035870010c9,513d6a0efdc9f0358700493b,wealthier,0,3,3
513f3327fdc9f0358700e118,514147c8fdc9f04926006b2a,safer,3,0,3
50f43b77fdc9f065f0003150,50f44859fdc9f065f0003ec5,safer,3,0,3
50f43b76fdc9f065f0003140,51421bcdfdc9f049260084c2,livelier,0,3,3
513e1e1bfdc9f03587009b92,513f10f5fdc9f0358700c791,safer,3,0,3
50f5611cfdc9f065f00053fa,513d9d85fdc9f035870080d7,livelier,3,0,3
513cc26cfdc9f03587001584,51408fc7fdc9f0492600016e,more beautiful,0,3,3
513cc1c6fdc9f035870014e2,5140db04fdc9f04926003e70,livelier,0,3,3
513cc152fdc9f03587001477,5140cb18fdc9f04926002a4e,more boring,1,2,3
513cc172fdc9f03587001495,51409a22fdc9f04926000ee3,more depressing,0,3,3
513d5991fdc9f0358700339f,513f2e80fdc9f0358700dc12,more depressing,2,1,3
513d585dfdc9f035870032eb,51408f88fdc9f049260000f1,more boring,1,2,3
513d5c28fdc9f0358700367e,51408a2dfdc9f0358700e68f,livelier,0,3,3
513d5a51fdc9f035870033f2,51422b3cfdc9f04926008a0c,safer,3,0,3
513d5d0cfdc9f03587003813,513d6a36fdc9f035870049c2,more beautiful,2,1,3
513d5c60fdc9f035870036e0,513d6bbefdc9f03587004dc1,safer,0,3,3
513d5c75fdc9f0358700370c,5185d29efdc9f03fd5001206,livelier,0,3,3
513cbf70fdc9f03587001296,513da015fdc9f035870088bb,safer,1,2,3
513cbc44fdc9f03587000f96,51414858fdc9f04926006c8c,more beautiful,3,0,3
513cbc86fdc9f03587000fd6,513e1ef2fdc9f03587009dd1,livelier,2,1,3
513cbc44fdc9f03587000f95,51409966fdc9f04926000def,more depressing,0,3,3
513d5d1bfdc9f0358700382a,513d6a03fdc9f03587004914,livelier,1,2,3
50f42f00fdc9f065f00025a7,51408cabfdc9f0358700eb8c,safer,3,0,3
50f42efffdc9f065f0002579,5140b773fdc9f049260019df,more boring,0,3,3
51408aeefdc9f0358700e81d,5140b621fdc9f0492600161a,livelier,3,0,3
513cbf8afdc9f035870012b5,513cd748fdc9f03587001f6a,more depressing,3,0,3
5140b877fdc9f04926001c5c,51422780fdc9f0492600867f,safer,0,3,3
5140b884fdc9f04926001c73,51413b26fdc9f049260058b6,livelier,3,0,3
50f42f00fdc9f065f000258e,513d9c05fdc9f03587007bd5,more boring,2,1,3
50f42f00fdc9f065f0002598,5185cf46fdc9f03fd5000ef9,livelier,3,0,3
51408a28fdc9f0358700e688,5140d5d9fdc9f04926003585,more depressing,3,0,3
51408a8bfdc9f0358700e747,51413c09fdc9f04926005aa5,livelier,2,1,3
513cb8fefdc9f03587000c92,51414eb4fdc9f049260078f1,livelier,3,0,3
513cb9e6fdc9f03587000d67,513cc630fdc9f03587001916,livelier,3,0,3
50f43aa8fdc9f065f0002e9f,50f561befdc9f065f000565f,safer,3,0,3
50f43aa9fdc9f065f0002eb4,513e60b8fdc9f0358700b437,livelier,3,0,3
50f43aa9fdc9f065f0002eb7,513d69b5fdc9f03587004817,safer,0,3,3
50f439f8fdc9f065f0002e0d,513d9e13fdc9f035870082b8,safer,3,0,3
513cbeccfdc9f035870011f1,51408bc1fdc9f0358700e9c4,livelier,3,0,3
513cbe1afdc9f03587001149,51414356fdc9f049260063bd,livelier,0,3,3
513cc113fdc9f0358700143e,513cc40efdc9f0358700171d,safer,0,3,3
513cc05afdc9f0358700137f,51421a87fdc9f04926008360,safer,3,0,3
513cc06efdc9f03587001396,51409d02fdc9f04926001271,livelier,3,0,3
513cbffafdc9f03587001326,51413314fdc9f049260041a7,livelier,1,2,3
513cbfecfdc9f03587001318,513ccda4fdc9f03587001d7c,safer,0,3,3
513cbf94fdc9f035870012be,513d695efdc9f035870046dd,livelier,0,3,3
50f5644dfdc9f065f000625a,51421b2afdc9f04926008412,more boring,0,3,3
50f56430fdc9f065f0006162,513d9d6ffdc9f03587008082,safer,3,0,3
50f56412fdc9f065f00060d0,513d2cc5fdc9f0358700245a,more beautiful,1,2,3
50f560edfdc9f065f00052fd,513da06afdc9f03587008987,livelier,2,1,3
513e1e96fdc9f03587009cde,513e5c03fdc9f0358700a9e2,livelier,1,2,3
513e1e5ffdc9f03587009c46,51409001fdc9f049260001e2,safer,3,0,3
513e1e71fdc9f03587009c7a,5140b863fdc9f04926001c2f,more beautiful,0,3,3
513cc268fdc9f0358700157f,51409146fdc9f04926000496,wealthier,3,0,3
50f42c7dfdc9f065f0001d2b,513d6abafdc9f03587004b3a,more beautiful,3,0,3
50f56410fdc9f065f000608c,51409eaefdc9f04926001481,livelier,0,3,3
50f563fefdc9f065f0005fcc,513d6886fdc9f035870043de,livelier,0,3,3
50f563fffdc9f065f0005fde,51413ba1fdc9f049260059e1,wealthier,3,0,3
50f563fbfdc9f065f0005f82,513d9f95fdc9f0358700878e,more depressing,0,3,3
50f563d4fdc9f065f0005f05,514217dcfdc9f04926008093,more beautiful,3,0,3
513d9f3afdc9f0358700868e,5140b7c4fdc9f04926001ad1,more beautiful,3,0,3
513e1d8ffdc9f03587009a27,513e7046fdc9f0358700c6ad,wealthier,0,3,3
513cc29cfdc9f035870015b1,513e1fe3fdc9f0358700a05c,safer,0,3,3
513cc2b8fdc9f035870015ca,51422d0bfdc9f04926008bc2,safer,3,0,3
50f42c6dfdc9f065f0001c16,50f563cdfdc9f065f0005e6e,wealthier,3,0,3
50f42c6dfdc9f065f0001c18,513d5c67fdc9f035870036ee,livelier,3,0,3
50f42c54fdc9f065f0001b2d,5140ca1afdc9f04926002729,safer,0,3,3
50f42c7dfdc9f065f0001d14,513d68bcfdc9f035870044a1,livelier,0,3,3
50f42c7dfdc9f065f0001d17,513d5eecfdc9f03587003b1d,more beautiful,2,1,3
50f42c7dfdc9f065f0001d21,50f55eb1fdc9f065f0004e2e,more boring,1,2,3
50f439f8fdc9f065f0002e01,513d3006fdc9f035870026d0,wealthier,3,0,3
51409036fdc9f0492600024f,5185d27dfdc9f03fd50011ec,livelier,0,3,3
513d56d0fdc9f03587003053,5140d898fdc9f04926003a3d,safer,0,3,3
513d5675fdc9f03587002fbc,513da080fdc9f035870089b1,more beautiful,2,1,3
513d5694fdc9f03587002ff4,513d7c84fdc9f03587006f14,safer,2,1,3
513d56b3fdc9f03587003021,51414f46fdc9f04926007a60,more depressing,3,0,3
50f4351efdc9f065f0002b71,5140cb3cfdc9f04926002ac0,safer,0,3,3
50f43519fdc9f065f0002b02,50f5eb68fdc9f065f00082a9,livelier,0,3,3
50f43534fdc9f065f0002ccc,51413487fdc9f049260046b1,safer,3,0,3
50f43531fdc9f065f0002c95,50f55e7dfdc9f065f0004d09,safer,1,2,3
51408f2afdc9f04926000033,51421be8fdc9f049260084d9,safer,2,1,3
51408be7fdc9f0358700ea0f,51413a34fdc9f0492600565b,livelier,0,3,3
513d577dfdc9f0358700318e,513e1ad8fdc9f035870092f4,wealthier,0,3,3
51408f95fdc9f04926000109,51414db4fdc9f0492600766b,safer,3,0,3
50f439eefdc9f065f0002d4d,51414cacfdc9f049260073ba,more beautiful,3,0,3
50f439f0fdc9f065f0002d6b,5185d104fdc9f03fd5001081,safer,0,3,3
513cc32cfdc9f0358700163a,513f2e83fdc9f0358700dc18,safer,0,3,3
51408c42fdc9f0358700eabe,51414302fdc9f0492600635b,safer,2,1,3
51408b8bfdc9f0358700e95e,5185ce3dfdc9f03fd5000df4,wealthier,0,3,3
5140ba2dfdc9f04926001f80,5140d6d9fdc9f049260036d1,livelier,3,0,3
5140b8c1fdc9f04926001cfa,5140c924fdc9f04926002452,safer,0,3,3
5140b919fdc9f04926001d9c,51422e2efdc9f04926008cc9,more boring,3,0,3
5140b7ecfdc9f04926001b30,5140d6e8fdc9f049260036e6,safer,0,3,3
50f43537fdc9f065f0002cff,5140da39fdc9f04926003d8a,livelier,3,0,3
513cbf45fdc9f03587001265,513e1a6cfdc9f035870091e1,safer,0,3,3
513cbf4afdc9f0358700126a,51414d53fdc9f0492600756f,livelier,0,3,3
513d57c9fdc9f03587003212,5185d10cfdc9f03fd500108c,safer,0,3,3
513cc4c0fdc9f035870017c4,513d7ccafdc9f03587006fe9,livelier,2,1,3
513cc500fdc9f03587001805,514143cdfdc9f04926006436,livelier,0,3,3
513cc37efdc9f03587001691,513f29e8fdc9f0358700d44b,more depressing,1,2,3
513cc38efdc9f035870016a0,513d9bd8fdc9f03587007b38,livelier,0,3,3
513cc324fdc9f03587001633,513e60c1fdc9f0358700b443,safer,0,3,3
50f4351cfdc9f065f0002b54,513cc172fdc9f03587001497,more depressing,0,3,3
50f4351dfdc9f065f0002b63,513cb87efdc9f03587000c16,more depressing,3,0,3
513cc35afdc9f0358700166f,5140cc5bfdc9f04926002da3,more beautiful,2,1,3
513d572bfdc9f035870030ff,5140b605fdc9f049260015d3,more boring,3,0,3
513d5754fdc9f0358700314c,51414686fdc9f0492600682b,safer,0,3,3
513d5779fdc9f03587003186,513d681dfdc9f03587004269,safer,3,0,3
513d56dcfdc9f03587003068,513e5d39fdc9f0358700ad2e,more depressing,1,2,3
513d56f5fdc9f03587003095,51414242fdc9f04926006296,safer,3,0,3
513d9f03fdc9f035870085d9,514135fcfdc9f04926004bb1,safer,0,3,3
513d9ed1fdc9f03587008524,513da079fdc9f035870089a2,more boring,2,1,3
513d9ed8fdc9f0358700853f,513f2989fdc9f0358700d3af,livelier,2,1,3
50f42c6efdc9f065f0001c40,513e617cfdc9f0358700b55b,livelier,2,1,3
50f42c72fdc9f065f0001c95,513e650efdc9f0358700b8fe,more boring,0,3,3
513d5709fdc9f035870030c3,514091a4fdc9f04926000550,more depressing,0,3,3
51409227fdc9f04926000661,5141503dfdc9f04926007cc5,more beautiful,0,3,3
50f4352bfdc9f065f0002c19,513e1fd1fdc9f0358700a02d,safer,0,3,3
50f56195fdc9f065f0005560,513e6039fdc9f0358700b372,safer,0,3,3
50f5612efdc9f065f00054ff,513d69d3fdc9f0358700487f,more depressing,1,2,3
50f563cffdc9f065f0005e90,5141354bfdc9f0492600496b,safer,2,1,3
50f563b5fdc9f065f0005de2,513d691cfdc9f035870045f6,livelier,3,0,3
513d9fe6fdc9f0358700884a,5140981bfdc9f04926000c34,wealthier,0,3,3
50f42c6dfdc9f065f0001c27,5140cae7fdc9f049260029b0,more depressing,1,2,3
50f42c6dfdc9f065f0001c2b,5140ca3cfdc9f0492600279b,livelier,1,2,3
5140cd4ffdc9f04926002f2e,51413c15fdc9f04926005ab9,safer,3,0,3
50f4351afdc9f065f0002b0e,513cc588fdc9f03587001882,safer,1,2,3
51409162fdc9f049260004d2,51422bf3fdc9f04926008ab0,safer,3,0,3
514091e9fdc9f049260005e0,514219e5fdc9f049260082b5,more boring,0,3,3
513e1cbbfdc9f035870097f6,5141393cfdc9f049260053ff,safer,0,3,3
513d9ff0fdc9f03587008862,5140ca10fdc9f04926002705,safer,0,3,3
513d9f5efdc9f0358700870e,513e6c8ffdc9f0358700c1a4,livelier,3,0,3
50f5612efdc9f065f0005525,50f6086abeb2fed6f800042d,more beautiful,3,0,3
50f5612ffdc9f065f0005537,51415082fdc9f04926007d80,more boring,3,0,3
514094b2fdc9f049260008d4,51414ca9fdc9f049260073b3,livelier,3,0,3
50f43515fdc9f065f0002aca,513d9e54fdc9f03587008390,more depressing,0,3,3
50f43516fdc9f065f0002adf,513d6e19fdc9f03587005267,wealthier,2,1,3
50f4349ffdc9f065f0002a95,513d2d28fdc9f035870024a5,safer,0,3,3
50f434a1fdc9f065f0002ab0,5140d6c1fdc9f049260036b8,safer,0,3,3
50f5619ffdc9f065f0005605,51414cf9fdc9f04926007483,more beautiful,0,3,3
50f561c5fdc9f065f00056e9,513f10c5fdc9f0358700c752,wealthier,3,0,3
50f561cbfdc9f065f0005709,51409dd8fdc9f0492600137a,more beautiful,1,2,3
513cc5d1fdc9f035870018c5,51413420fdc9f0492600453b,wealthier,3,0,3
513cc632fdc9f03587001918,513e22b6fdc9f0358700a5b7,safer,2,1,3
513cc59efdc9f03587001896,513f297ffdc9f0358700d3a1,safer,3,0,3
513cc5bcfdc9f035870018b3,5140b71afdc9f049260018ee,more depressing,0,3,3
51413ccefdc9f04926005bd2,5141472cfdc9f049260069c8,safer,0,3,3
50f4348efdc9f065f0002975,50f55e99fdc9f065f0004d74,livelier,3,0,3
50f43492fdc9f065f00029b5,51413498fdc9f049260046f7,livelier,1,2,3
51409864fdc9f04926000c97,5140d580fdc9f049260034ce,livelier,0,3,3
51413a6efdc9f049260056e5,51414bf3fdc9f049260071ec,livelier,3,0,3
514138c0fdc9f049260052c7,51414e6cfdc9f04926007847,more beautiful,3,0,3
51413936fdc9f049260053f1,51421c3dfdc9f04926008533,more boring,3,0,3
5141396dfdc9f0492600547e,51414da6fdc9f04926007649,safer,3,0,3
514137e3fdc9f049260050bd,5185ceddfdc9f03fd5000e8c,safer,0,3,3
5141380efdc9f0492600512a,51422804fdc9f049260086fd,safer,0,3,3
513cc6fafdc9f035870019d9,513e6a63fdc9f0358700beb9,safer,1,2,3
513cc700fdc9f035870019e0,51414b86fdc9f049260070e0,livelier,3,0,3
513d5708fdc9f035870030c2,51414770fdc9f04926006a60,safer,1,2,3
50f42b87fdc9f065f00014ba,50f5640afdc9f065f0006001,more beautiful,0,3,3
50f42b88fdc9f065f00014dd,513e20ecfdc9f0358700a326,more beautiful,3,0,3
513cc516fdc9f0358700181a,514092c2fdc9f049260006ee,livelier,3,0,3
513cc536fdc9f0358700183a,513d5f3bfdc9f03587003b81,safer,2,1,3
50f42b89fdc9f065f000153f,50f5ebaafdc9f065f000843e,livelier,3,0,3
50f42b88fdc9f065f00014fa,513ceac5fdc9f0358700234d,wealthier,3,0,3
50f42b87fdc9f065f00014b6,513cbfeefdc9f03587001319,more beautiful,3,0,3
513d37f0fdc9f03587002c29,513d7d2dfdc9f0358700712b,livelier,0,3,3
513d3886fdc9f03587002c5f,513d6d21fdc9f035870050d6,more beautiful,0,3,3
513d36f8fdc9f03587002bcc,513e218cfdc9f0358700a45b,livelier,3,0,3
513cd33cfdc9f03587001e8c,51409ddafdc9f0492600137d,more boring,0,3,3
513ccf74fdc9f03587001dd5,513d5f70fdc9f03587003bc0,safer,0,3,3
513ccfdefdc9f03587001de8,513e5dcafdc9f0358700aebe,more boring,3,0,3
513da0fffdc9f03587008a74,5140c8d2fdc9f0492600235a,wealthier,0,3,3
513da115fdc9f03587008a8f,513e2082fdc9f0358700a212,livelier,0,3,3
51409ac1fdc9f04926000faa,5140b6eefdc9f0492600186d,safer,3,0,3
51409974fdc9f04926000e03,51414fbefdc9f04926007b85,livelier,3,0,3
51409982fdc9f04926000e15,51414f43fdc9f04926007a59,safer,0,3,3
51409a34fdc9f04926000efa,51413b81fdc9f04926005993,safer,0,3,3
5140990efdc9f04926000d7c,51421c9efdc9f0492600859f,more boring,1,2,3
51409a99fdc9f04926000f7a,5140cbd7fdc9f04926002c6f,livelier,3,0,3
513ccb66fdc9f03587001d03,513e6117fdc9f0358700b4ce,more beautiful,3,0,3
513cc9a8fdc9f03587001c52,514146ddfdc9f049260068fe,livelier,3,0,3
50f561c4fdc9f065f00056ca,513cc6e0fdc9f035870019bf,safer,3,0,3
513e1cbbfdc9f035870097f8,51415036fdc9f04926007cb4,safer,1,2,3
513e1cd7fdc9f03587009840,513e5cfffdc9f0358700ac8c,more beautiful,0,3,3
50f5640bfdc9f065f0006029,513d6bd8fdc9f03587004e04,safer,0,3,3
50f56410fdc9f065f000608b,513d684afdc9f03587004306,livelier,0,3,3
513e1d31fdc9f03587009930,5140ca93fdc9f049260028a4,more boring,2,1,3
513e1d65fdc9f035870099b7,5140d31dfdc9f0492600337e,safer,0,3,3
50f43514fdc9f065f0002abd,514133e6fdc9f0492600447d,more beautiful,3,0,3
50f561bffdc9f065f0005681,51413479fdc9f04926004683,more boring,3,0,3
50f561c1fdc9f065f000568c,513d3249fdc9f03587002897,more depressing,0,3,3
50f561c1fdc9f065f000569b,513e5fe4fdc9f0358700b2ea,livelier,3,0,3
50f561a0fdc9f065f0005610,513d67a7fdc9f03587004123,safer,0,3,3
50f561bcfdc9f065f000563d,514145edfdc9f049260066c1,safer,0,3,3
50f5635ffdc9f065f0005cd0,51392442818ede1296000fe4,wealthier,0,3,3
50f56360fdc9f065f0005ce0,51408fb3fdc9f04926000146,more beautiful,0,3,3
513e1cd8fdc9f03587009844,513f2abbfdc9f0358700d5af,more depressing,0,3,3
513cc7b2fdc9f03587001a85,513e5cd0fdc9f0358700ac0f,livelier,0,3,3
513d4d70fdc9f03587002e53,51413726fdc9f04926004e03,more depressing,3,0,3
513d4a18fdc9f03587002de1,513e5df1fdc9f0358700af29,safer,0,3,3
513d4ae8fdc9f03587002dfa,513d6ba6fdc9f03587004d8e,livelier,3,0,3
513cc90efdc9f03587001bcc,513d9c5bfdc9f03587007cec,more beautiful,3,0,3
513cc851fdc9f03587001b1b,513d30b2fdc9f03587002756,safer,3,0,3
513cc878fdc9f03587001b3b,5185cb51fdc9f03fd5000b15,safer,3,0,3
51409a49fdc9f04926000f17,5141514bfdc9f04926007f5b,livelier,3,0,3
50f561befdc9f065f0005664,513e618efdc9f0358700b577,safer,0,3,3
50f56198fdc9f065f000558d,513d5d63fdc9f035870038ac,livelier,0,3,3
50f56198fdc9f065f00055ac,51413d33fdc9f04926005ca5,more beautiful,0,3,3
50f5619ffdc9f065f0005605,5140cc25fdc9f04926002d1e,more beautiful,0,3,3
513cca04fdc9f03587001cac,513d7be8fdc9f03587006d04,wealthier,3,0,3
513cc880fdc9f03587001b40,513e5ddafdc9f0358700aeee,livelier,0,3,3
513cc73afdc9f03587001a17,5140901bfdc9f04926000213,livelier,0,3,3
513cc78afdc9f03587001a5c,5140caedfdc9f049260029c0,livelier,0,3,3
50f562ddfdc9f065f0005af0,51408c04fdc9f0358700ea47,safer,3,0,3
50f56203fdc9f065f0005873,513e1aacfdc9f0358700928c,more boring,0,3,3
50f561fbfdc9f065f000582d,513f1507fdc9f0358700cd29,livelier,2,1,3
50f561ccfdc9f065f0005764,5141352dfdc9f04926004905,more beautiful,3,0,3
50f561f3fdc9f065f00057bc,513d6101fdc9f03587003dba,livelier,0,3,3
50f563d0fdc9f065f0005eb2,50f60c51beb2fed9100002ce,livelier,0,3,3
50f563d2fdc9f065f0005ee3,51415082fdc9f04926007d80,wealthier,3,0,3
50f561bdfdc9f065f0005652,513d7f78fdc9f035870075ff,safer,3,0,3
50f562d5fdc9f065f0005a85,51413a4ffdc9f0492600569d,livelier,3,0,3
50f56268fdc9f065f0005a32,513d78d0fdc9f035870062c8,more beautiful,3,0,3
50f56268fdc9f065f0005a4d,513f30f5fdc9f0358700df41,safer,0,3,3
513e1af3fdc9f03587009337,51414f3bfdc9f04926007a44,more beautiful,0,3,3
513e1b59fdc9f03587009458,51414774fdc9f04926006a67,more beautiful,0,3,3
513e1b6cfdc9f0358700948c,5140b66afdc9f049260016ee,safer,3,0,3
513e1b26fdc9f035870093c0,51413fc3fdc9f04926006009,safer,0,3,3
50f562dafdc9f065f0005ae9,514136aefdc9f04926004cad,wealthier,3,0,3
513d345afdc9f03587002a13,513d6c18fdc9f03587004ea7,more beautiful,0,3,3
513d346efdc9f03587002a23,5140d9eefdc9f04926003cef,more boring,1,2,3
513d34b6fdc9f03587002a57,5141478efdc9f04926006a9f,safer,0,3,3
50f433c3fdc9f065f000263c,513d5e1dfdc9f035870039f3,livelier,3,0,3
50f42f01fdc9f065f00025c3,513cc4bafdc9f035870017be,safer,0,3,3
50f42f01fdc9f065f00025e4,513d6c1efdc9f03587004eb8,livelier,0,3,3
5140b609fdc9f049260015d8,51422c93fdc9f04926008b47,more beautiful,3,0,3
5140b663fdc9f049260016da,5140cb48fdc9f04926002ae9,wealthier,0,3,3
513d3656fdc9f03587002b8b,51409c0efdc9f0492600114b,more beautiful,0,3,3
513d358dfdc9f03587002af3,513d9d6afdc9f03587008075,more depressing,3,0,3
50f433d6fdc9f065f000276d,513d7fdafdc9f03587007659,livelier,0,3,3
50f433d8fdc9f065f00027a0,513d5e77fdc9f03587003a80,more boring,2,1,3
50f433d9fdc9f065f00027bb,50f5e898fdc9f065f00073cc,livelier,1,2,3
51409ca3fdc9f04926001201,5141342afdc9f0492600455d,livelier,0,3,3
51409b8efdc9f049260010b3,51421b85fdc9f0492600846d,more beautiful,0,3,3
51409b96fdc9f049260010be,51414ef1fdc9f04926007985,more boring,3,0,3
50f433d4fdc9f065f0002748,5141502dfdc9f04926007c9f,safer,0,3,3
50f433d5fdc9f065f0002759,51413453fdc9f04926004603,safer,0,3,3
50f433d5fdc9f065f0002760,513d9f9bfdc9f0358700879b,more boring,3,0,3
50f433d2fdc9f065f000271f,513d9ab6fdc9f0358700779b,wealthier,0,3,3
50f433d2fdc9f065f0002728,50f43518fdc9f065f0002af3,safer,3,0,3
50f4348cfdc9f065f000293f,50f61683beb2fed910000990,wealthier,3,0,3
513d36f8fdc9f03587002bcc,513e225afdc9f0358700a544,more depressing,3,0,3
513d37a0fdc9f03587002c0a,5140b909fdc9f04926001d7a,livelier,0,3,3
513cd5e0fdc9f03587001f1c,51422d88fdc9f04926008c36,more depressing,3,0,3
513cd35cfdc9f03587001e8f,513d7a07fdc9f035870066bd,wealthier,0,3,3
513cd3bafdc9f03587001ea4,5140d78dfdc9f0492600382a,more depressing,3,0,3
50f4348dfdc9f065f0002961,513d9b4efdc9f0358700798e,more beautiful,0,3,3
50f43480fdc9f065f00028c3,513e6c28fdc9f0358700c11b,more boring,3,0,3
50f43488fdc9f065f00028fb,5140c9a2fdc9f049260025c3,safer,0,3,3
50f4347ffdc9f065f00028ab,51414d3dfdc9f04926007538,safer,3,0,3
50f43477fdc9f065f000281f,50f44502fdc9f065f0003370,more depressing,3,0,3
50e5f7d6d7c3df413b000580,513d7c3bfdc9f03587006e17,livelier,0,3,3
513d2d61fdc9f035870024d2,513e5cdefdc9f0358700ac2e,more depressing,0,3,3
50e5f7d5d7c3df413b000571,50f44563fdc9f065f00034a4,more beautiful,0,3,3
513d2e86fdc9f035870025a8,513d7cb7fdc9f03587006faa,livelier,3,0,3
51414d1efdc9f049260074e2,514150c3fdc9f04926007e1f,more depressing,0,3,3
51414d5efdc9f0492600758d,51421815fdc9f049260080d5,livelier,0,3,3
513d2e78fdc9f0358700259e,513f1349fdc9f0358700cab4,more boring,0,3,3
514142b1fdc9f0492600630a,514142e8fdc9f04926006341,more beautiful,3,0,3
50e748e9d7c3df413b001444,50f5e58efdc9f065f00069f8,safer,1,2,3
50e748e3d7c3df413b0013b9,5140cad0fdc9f04926002960,safer,0,3,3
50e748e3d7c3df413b0013ba,513f2c3efdc9f0358700d82f,livelier,3,0,3
513cec97fdc9f035870023a9,513d580dfdc9f0358700328c,livelier,0,3,3
513cef19fdc9f0358700241e,513d7cbcfdc9f03587006fbc,safer,3,0,3
513e1c64fdc9f0358700971c,51414c47fdc9f049260072c4,wealthier,0,3,3
513d2d22fdc9f035870024a1,51413b1cfdc9f049260058a0,livelier,0,3,3
513e1c55fdc9f035870096f1,513e1ca3fdc9f035870097c0,livelier,2,1,3
513d303efdc9f035870026fa,51413852fdc9f049260051c6,more depressing,0,3,3
513d323cfdc9f0358700288a,51408af2fdc9f0358700e826,wealthier,0,3,3
513d3227fdc9f0358700287b,514229f4fdc9f049260088bf,livelier,0,3,3
513d314bfdc9f035870027d0,513e6d61fdc9f0358700c2b3,livelier,3,0,3
513d3174fdc9f035870027f0,513e6c40fdc9f0358700c13d,more boring,3,0,3
513d31a4fdc9f03587002813,513d9f09fdc9f035870085ed,more depressing,2,1,3
50f42b80fdc9f065f0001455,514137bffdc9f0492600502c,safer,1,2,3
513e1bb6fdc9f03587009543,513e212cfdc9f0358700a3de,livelier,0,3,3
513cde7afdc9f035870020ef,513d7ee7fdc9f035870074dc,safer,3,0,3
513cdf67fdc9f03587002126,513d5d48fdc9f03587003879,safer,3,0,3
513cdb20fdc9f03587002032,513e217ffdc9f0358700a44c,wealthier,0,3,3
50e748e5d7c3df413b0013e9,50f43b91fdc9f065f0003233,more depressing,0,3,3
50e73275d7c3df413b000e22,513d3730fdc9f03587002be3,more beautiful,3,0,3
514227d7fdc9f049260086d7,5185d178fdc9f03fd50010f7,livelier,2,1,3
50e5faead7c3df413b00073b,51414ef2fdc9f04926007987,safer,2,1,3
50e5f7d9d7c3df413b0005a5,513cc485fdc9f0358700178e,wealthier,2,1,3
5140b727fdc9f0492600190f,514147cefdc9f04926006b38,safer,0,3,3
5140b688fdc9f04926001755,514151b5fdc9f04926007fe6,livelier,0,3,3
5140b696fdc9f04926001782,514133bdfdc9f049260043e8,wealthier,3,0,3
5140b6b4fdc9f049260017ca,5140caccfdc9f04926002951,safer,0,3,3
5140b6bffdc9f049260017ef,51413d1dfdc9f04926005c75,livelier,0,3,3
50f42b80fdc9f065f0001440,513d31a0fdc9f03587002810,more boring,3,0,3
513d30d6fdc9f03587002773,5140923dfdc9f04926000676,livelier,2,1,3
50f56205fdc9f065f00058f9,51414658fdc9f049260067b6,more depressing,0,3,3
513d31bcfdc9f03587002825,51413866fdc9f049260051f1,safer,3,0,3
50f42b82fdc9f065f0001466,50f5644bfdc9f065f0006223,livelier,1,2,3
50f42b7efdc9f065f0001410,513cc0a6fdc9f035870013ce,livelier,0,3,3
50f42b7bfdc9f065f00013bb,5140c9f4fdc9f049260026ba,more beautiful,0,3,3
50f42b7bfdc9f065f00013c4,513d78b6fdc9f03587006267,safer,0,3,3
50f42b51fdc9f065f000132f,50f42eaafdc9f065f00022bb,safer,1,2,3
50f42b51fdc9f065f0001342,513f2f53fdc9f0358700dd6e,safer,0,3,3
51413b45fdc9f04926005900,51422d1afdc9f04926008bcf,more boring,3,0,3
5140b7e9fdc9f04926001b29,5140d892fdc9f04926003a34,safer,3,0,3
5140b713fdc9f049260018d6,51413c10fdc9f04926005ab0,livelier,3,0,3
5140b725fdc9f0492600190a,51422d9dfdc9f04926008c47,wealthier,3,0,3
513d2e49fdc9f0358700257b,5141467dfdc9f04926006814,more beautiful,0,3,3
50e748e9d7c3df413b001446,513e1be3fdc9f035870095be,safer,3,0,3
513d2ef8fdc9f03587002602,51413531fdc9f04926004915,safer,3,0,3
5142187afdc9f04926008141,51422e67fdc9f04926008d09,safer,3,0,3
51421a69fdc9f04926008339,51422a6bfdc9f04926008938,safer,1,2,3
51414651fdc9f049260067a6,51422846fdc9f04926008741,wealthier,3,0,3
514146affdc9f0492600688d,514150b1fdc9f04926007df7,safer,1,2,3
51413d7ffdc9f04926005d57,514218f5fdc9f049260081bc,safer,0,3,3
50f42b51fdc9f065f000130a,513d780efdc9f03587006034,safer,0,3,3
513d2feafdc9f035870026b9,5140d7c0fdc9f04926003892,safer,0,3,3
513d2ffffdc9f035870026cb,51414d31fdc9f04926007519,livelier,2,1,3
513d301afdc9f035870026e0,5140ca3bfdc9f04926002796,more beautiful,0,3,3
51414d93fdc9f04926007617,5185cfa8fdc9f03fd5000f60,wealthier,3,0,3
50e5f7d6d7c3df413b000580,50f4347bfdc9f065f000285d,wealthier,0,2,2
50e5faead7c3df413b000738,50f60c4bbeb2fed910000256,livelier,0,2,2
50e5faebd7c3df413b000748,513d9a91fdc9f03587007711,wealthier,0,2,2
50e5faebd7c3df413b00074a,50f433d3fdc9f065f000273f,wealthier,0,2,2
50e5faecd7c3df413b00075e,50f42b52fdc9f065f0001355,safer,2,0,2
50e5faeed7c3df413b000775,50f60c45beb2fed9100001d4,livelier,0,2,2
50e5faeed7c3df413b00077b,51414629fdc9f0492600674d,wealthier,0,2,2
50e748e3d7c3df413b0013b7,513cbd05fdc9f03587001041,more depressing,2,0,2
50e748e4d7c3df413b0013c4,513cbe10fdc9f0358700113f,wealthier,0,2,2
50e748e4d7c3df413b0013d4,513d7ab8fdc9f03587006919,more depressing,0,2,2
50e748e6d7c3df413b001400,513e5cbdfdc9f0358700abd9,safer,0,2,2
50e748e8d7c3df413b001424,513cd644fdc9f03587001f2d,more beautiful,2,0,2
50f42b52fdc9f065f0001364,513d788afdc9f035870061d1,safer,2,0,2
50f42b52fdc9f065f000136b,5140ca8efdc9f04926002896,more boring,0,2,2
50f42b7bfdc9f065f00013ad,50f44811fdc9f065f0003d3f,more beautiful,2,0,2
50f42b7cfdc9f065f00013e2,50f433dafdc9f065f00027d3,livelier,2,0,2
50f42b7cfdc9f065f00013e3,51409d68fdc9f049260012eb,livelier,0,2,2
50f42b7efdc9f065f0001401,50f42c54fdc9f065f0001b34,livelier,2,0,2
50f42b80fdc9f065f000143a,513e600efdc9f0358700b32d,safer,2,0,2
51413ab0fdc9f0492600578e,5185ced8fdc9f03fd5000e8b,livelier,2,0,2
51413ae7fdc9f04926005816,5185cb66fdc9f03fd5000b26,safer,0,2,2
51413c26fdc9f04926005ad0,51422a65fdc9f04926008933,wealthier,2,0,2
51413cbffdc9f04926005baf,5185cb9dfdc9f03fd5000b5d,livelier,2,0,2
51413d2efdc9f04926005c97,51414faefdc9f04926007b5e,safer,2,0,2
51413d5dfdc9f04926005d0c,51414f98fdc9f04926007b29,livelier,0,2,2
50f42b51fdc9f065f0001324,514145d0fdc9f04926006680,safer,0,2,2
50f42b51fdc9f065f0001341,513d7f2cfdc9f0358700756e,more boring,0,2,2
50f42babfdc9f065f0001574,514141a4fdc9f049260061ef,livelier,2,0,2
514137e2fdc9f049260050b8,5141498ffdc9f04926006e02,safer,2,0,2
51413821fdc9f04926005155,514149b9fdc9f04926006e46,more boring,2,0,2
5141382afdc9f04926005169,51414ec3fdc9f04926007913,more beautiful,0,2,2
51413883fdc9f04926005230,514219aefdc9f04926008276,safer,0,2,2
51413886fdc9f04926005238,5185d392fdc9f03fd50012ed,safer,2,0,2
514139c6fdc9f0492600554c,51413cadfdc9f04926005b85,wealthier,0,2,2
51413a42fdc9f04926005680,5185cbcffdc9f03fd5000b91,safer,0,2,2
50f42b88fdc9f065f00014f0,50f463c6fdc9f065f000432a,more beautiful,2,0,2
50f42b88fdc9f065f00014f2,51421ba3fdc9f0492600848e,wealthier,0,2,2
50f42b88fdc9f065f000151c,513e1fccfdc9f0358700a01b,more depressing,0,2,2
50f42b89fdc9f065f0001530,513d7bcdfdc9f03587006cab,wealthier,2,0,2
50f42b89fdc9f065f0001538,50f46483fdc9f065f0004699,safer,2,0,2
50f42babfdc9f065f000155d,50f445aafdc9f065f0003557,wealthier,2,0,2
50f42babfdc9f065f000156d,513d9c89fdc9f03587007d90,safer,2,0,2
513ce62bfdc9f03587002263,5140b8f4fdc9f04926001d56,livelier,0,2,2
513ce643fdc9f03587002269,514091eafdc9f049260005e1,safer,0,2,2
513ce6c5fdc9f03587002280,51414826fdc9f04926006c0b,livelier,0,2,2
513ce6d1fdc9f03587002281,513d6946fdc9f03587004687,safer,0,2,2
513ce6d1fdc9f03587002281,513e620efdc9f0358700b63b,more depressing,0,2,2
513ce71bfdc9f0358700228d,513f2d6cfdc9f0358700da30,livelier,2,0,2
513ce78ffdc9f035870022aa,514135ddfdc9f04926004b65,livelier,0,2,2
513ce78ffdc9f035870022aa,514135ddfdc9f04926004b65,more beautiful,0,2,2
513d31e5fdc9f03587002847,513d9b5bfdc9f035870079b3,livelier,0,2,2
513d3205fdc9f0358700285e,5140b77bfdc9f049260019f4,wealthier,2,0,2
513d3220fdc9f03587002874,514141fcfdc9f04926006249,safer,2,0,2
513d324afdc9f03587002898,51414281fdc9f049260062d8,more beautiful,2,0,2
513d3274fdc9f035870028b6,513e61ccfdc9f0358700b5d6,more boring,2,0,2
513d32e4fdc9f0358700290d,513d6c7cfdc9f03587004f9c,more beautiful,2,0,2
513d331cfdc9f03587002931,513e5c60fdc9f0358700aadb,more boring,2,0,2
513d30f0fdc9f03587002784,51413a2efdc9f0492600564c,more depressing,2,0,2
513d30f8fdc9f0358700278a,51413b2ffdc9f049260058ca,more boring,2,0,2
513d311cfdc9f035870027ab,51413366fdc9f049260042bb,safer,2,0,2
513d3144fdc9f035870027c9,514146e8fdc9f0492600691c,livelier,2,0,2
513d3150fdc9f035870027d4,51413470fdc9f04926004668,safer,0,2,2
513d3188fdc9f03587002800,513d5c5cfdc9f035870036dc,livelier,2,0,2
513d31c2fdc9f0358700282b,5140da6cfdc9f04926003dc6,more beautiful,0,2,2
513d31cafdc9f0358700282f,513d79a8fdc9f0358700658c,safer,2,0,2
513d2db8fdc9f03587002511,51422738fdc9f04926008636,safer,2,0,2
513d2deafdc9f03587002536,51414d11fdc9f049260074b8,more boring,2,0,2
513d2e28fdc9f0358700255f,513e5da3fdc9f0358700ae56,livelier,2,0,2
513d2e67fdc9f03587002592,51414277fdc9f049260062cd,livelier,2,0,2
513d2e8afdc9f035870025ad,513d5727fdc9f035870030f8,livelier,0,2,2
513d2ebefdc9f035870025d8,5140c92dfdc9f04926002468,more beautiful,0,2,2
513d30a5fdc9f0358700274c,513d61b8fdc9f03587003e9f,wealthier,2,0,2
513cdf61fdc9f03587002125,5140ba27fdc9f04926001f7b,safer,0,2,2
513ce051fdc9f03587002154,513f2b9bfdc9f0358700d71d,more beautiful,2,0,2
513ce131fdc9f03587002183,513e1de2fdc9f03587009afb,more boring,2,0,2
513ce185fdc9f03587002194,513d7ab4fdc9f0358700690b,safer,0,2,2
513ce241fdc9f035870021b5,513d571bfdc9f035870030e1,more beautiful,0,2,2
513ce38efdc9f035870021e7,513d5c4dfdc9f035870036be,livelier,0,2,2
513d34defdc9f03587002a73,513e6cfffdc9f0358700c22b,more depressing,0,2,2
513d3527fdc9f03587002aa4,5140d9c3fdc9f04926003c93,more boring,0,2,2
513d3528fdc9f03587002aa5,513e5c8ffdc9f0358700ab60,more beautiful,2,0,2
513cdc16fdc9f0358700206e,5185ce8cfdc9f03fd5000e43,more beautiful,0,2,2
513cdc3afdc9f03587002071,513e6ef3fdc9f0358700c4db,livelier,0,2,2
513cdcf6fdc9f0358700209a,5140b9fffdc9f04926001f52,safer,0,2,2
513cdd5cfdc9f035870020b4,513f2e01fdc9f0358700db3b,more boring,2,0,2
513cde3cfdc9f035870020e0,5140917cfdc9f04926000509,more depressing,2,0,2
513d337dfdc9f03587002974,514139cdfdc9f04926005558,safer,0,2,2
513d33aefdc9f0358700298b,513e1c91fdc9f03587009792,livelier,0,2,2
513d33d8fdc9f035870029b4,513d600dfdc9f03587003c82,more depressing,0,2,2
513d33ebfdc9f035870029c2,51408bb8fdc9f0358700e9b3,wealthier,2,0,2
513d349bfdc9f03587002a42,513e5d35fdc9f0358700ad20,safer,0,2,2
513d34cafdc9f03587002a68,513e5fa2fdc9f0358700b288,livelier,2,0,2
513ce81dfdc9f035870022c6,5140b74bfdc9f04926001976,more depressing,0,2,2
513ce83ffdc9f035870022d1,5140c9cbfdc9f04926002639,wealthier,0,2,2
513ce94afdc9f03587002306,513e1fcbfdc9f0358700a018,safer,0,2,2
513ceac5fdc9f0358700234d,513e23acfdc9f0358700a6d5,more depressing,2,0,2
513ced25fdc9f035870023c7,513d69cafdc9f0358700485f,livelier,0,2,2
513d3363fdc9f03587002962,5185ce99fdc9f03fd5000e4f,livelier,0,2,2
513d337cfdc9f03587002973,513e1e43fdc9f03587009bfa,more boring,0,2,2
513d38b8fdc9f03587002c75,51409804fdc9f04926000c17,safer,2,0,2
513d38b8fdc9f03587002c75,5140b82cfdc9f04926001bbb,more depressing,2,0,2
513cc90efdc9f03587001bcc,51421b08fdc9f049260083ea,safer,0,2,2
513cc96cfdc9f03587001c21,51409c6dfdc9f049260011c3,more depressing,2,0,2
513cc989fdc9f03587001c3a,51415154fdc9f04926007f74,livelier,0,2,2
513cc9e1fdc9f03587001c87,513d7c02fdc9f03587006d59,more depressing,2,0,2
513cc9e2fdc9f03587001c88,513d6e30fdc9f0358700528a,safer,0,2,2
513d35acfdc9f03587002b0e,513e5ec6fdc9f0358700b140,wealthier,2,0,2
513d35f6fdc9f03587002b47,51414d19fdc9f049260074d1,safer,0,2,2
513d36a2fdc9f03587002baf,51408f74fdc9f049260000d0,safer,2,0,2
513d36e4fdc9f03587002bc6,513e701ffdc9f0358700c67e,safer,2,0,2
513d36ecfdc9f03587002bc8,5185d3fbfdc9f03fd500135b,wealthier,0,2,2
513d37c0fdc9f03587002c15,51422b42fdc9f04926008a13,more beautiful,2,0,2
513d37c2fdc9f03587002c16,513e607efdc9f0358700b3db,more beautiful,0,2,2
513cd730fdc9f03587001f65,513cebe1fdc9f03587002385,livelier,0,2,2
513cd7f4fdc9f03587001f92,513f14effdc9f0358700cd03,safer,2,0,2
513cd8a4fdc9f03587001fb5,513d6cb1fdc9f03587005023,livelier,2,0,2
513cda68fdc9f03587002013,513e6f5efdc9f0358700c570,more beautiful,2,0,2
513cdb18fdc9f03587002031,513d9e3ffdc9f03587008352,livelier,0,2,2
513d3574fdc9f03587002adf,51422c3dfdc9f04926008af6,livelier,0,2,2
513cd372fdc9f03587001e96,51409004fdc9f049260001e7,more beautiful,0,2,2
513cd4dcfdc9f03587001ee2,5141509cfdc9f04926007dc3,wealthier,0,2,2
513cd54efdc9f03587001eff,513e703efdc9f0358700c6a2,more beautiful,0,2,2
513cd5e8fdc9f03587001f1e,5140897bfdc9f0358700e50c,more beautiful,0,2,2
513cd60cfdc9f03587001f22,513e5e68fdc9f0358700b072,more beautiful,0,2,2
513cd6eafdc9f03587001f54,5140d7f3fdc9f049260038ff,safer,2,0,2
513d528efdc9f03587002eef,513f2b06fdc9f0358700d62c,safer,0,2,2
513d5354fdc9f03587002f05,513d7b56fdc9f03587006b1f,safer,2,0,2
513d54a6fdc9f03587002f31,513d9d3dfdc9f03587007fe1,wealthier,2,0,2
513d5659fdc9f03587002f88,513d6cddfdc9f03587005068,more beautiful,0,2,2
513cc568fdc9f03587001865,5185cd08fdc9f03fd5000cca,safer,2,0,2
513cc592fdc9f0358700188b,513d68b2fdc9f03587004478,more depressing,0,2,2
513cc594fdc9f0358700188e,514134c0fdc9f04926004786,more depressing,2,0,2
513cc596fdc9f03587001890,51413337fdc9f0492600421c,livelier,2,0,2
513d49cafdc9f03587002dd3,513e60f0fdc9f0358700b496,more beautiful,0,2,2
513d4aa2fdc9f03587002df3,5185cedffdc9f03fd5000e8e,livelier,0,2,2
513d4b81fdc9f03587002e13,51414391fdc9f049260063fc,more beautiful,0,2,2
513d4c5ffdc9f03587002e2d,51409d22fdc9f0492600129a,more beautiful,0,2,2
513d4d1afdc9f03587002e43,513d9b86fdc9f03587007a38,more depressing,0,2,2
513d4d54fdc9f03587002e4d,513d6c93fdc9f03587004fd6,livelier,2,0,2
513d4d88fdc9f03587002e56,5140cf92fdc9f0492600315b,livelier,0,2,2
513d4db4fdc9f03587002e5a,5185ce3dfdc9f03fd5000df4,wealthier,2,0,2
513cc784fdc9f03587001a56,513d6c59fdc9f03587004f4c,more beautiful,2,0,2
513cc784fdc9f03587001a57,514149abfdc9f04926006e2b,wealthier,0,2,2
513cc840fdc9f03587001b07,5140b8bcfdc9f04926001cea,livelier,0,2,2
513cc88efdc9f03587001b52,513d9ed4fdc9f0358700852e,safer,0,2,2
513cc89efdc9f03587001b5e,513f2c7dfdc9f0358700d89e,more beautiful,0,2,2
513cc8c4fdc9f03587001b80,5140ca08fdc9f049260026ec,livelier,0,2,2
513cc8ecfdc9f03587001baa,513d9e52fdc9f0358700838e,wealthier,0,2,2
513cc8eefdc9f03587001bad,5141456ffdc9f049260065eb,more depressing,2,0,2
513cc9f2fdc9f03587001c9c,513f1277fdc9f0358700c993,more beautiful,0,2,2
513cc9f8fdc9f03587001ca2,513e1f64fdc9f03587009eff,more boring,0,2,2
513cce30fdc9f03587001d9a,513d6ac9fdc9f03587004b66,more boring,2,0,2
513ccf04fdc9f03587001dbd,51408fa1fdc9f0492600011f,safer,2,0,2
513cd1fafdc9f03587001e51,513d9cb6fdc9f03587007e29,more depressing,0,2,2
513cd2fefdc9f03587001e81,5140caa6fdc9f049260028da,livelier,0,2,2
513cd310fdc9f03587001e84,513e6d3ffdc9f0358700c284,livelier,2,0,2
513cc742fdc9f03587001a1c,513cc920fdc9f03587001bda,safer,0,2,2
513cc3d2fdc9f035870016e4,513cc816fdc9f03587001adf,more boring,2,0,2
513cc3e4fdc9f035870016f4,513e2345fdc9f0358700a658,wealthier,2,0,2
513cc400fdc9f03587001710,513d4b9cfdc9f03587002e18,wealthier,0,2,2
513cc472fdc9f03587001780,5141471cfdc9f0492600699e,more beautiful,2,0,2
513cc480fdc9f0358700178b,5140cc6ffdc9f04926002dcf,more beautiful,0,2,2
513cc4b2fdc9f035870017b7,51422c21fdc9f04926008adb,wealthier,2,0,2
513cc4f2fdc9f035870017f9,513f29f9fdc9f0358700d46d,livelier,0,2,2
513d5786fdc9f0358700319d,5140c94afdc9f049260024bb,more depressing,0,2,2
513d5700fdc9f035870030b2,513f13e6fdc9f0358700cb88,more boring,0,2,2
513d572efdc9f03587003103,5185cfa0fdc9f03fd5000f58,livelier,0,2,2
513d573dfdc9f03587003124,513f2ebefdc9f0358700dc82,more boring,2,0,2
513cc352fdc9f03587001664,5140b92afdc9f04926001dc1,more depressing,2,0,2
513cc36efdc9f03587001684,513e1df0fdc9f03587009b1d,safer,0,2,2
513cc3c4fdc9f035870016d6,513d7a49fdc9f03587006798,livelier,2,0,2
513cc3cefdc9f035870016e1,513e6d0afdc9f0358700c23c,safer,0,2,2
513cc6aafdc9f0358700198c,513d7cb9fdc9f03587006fb2,livelier,2,0,2
513cc6d0fdc9f035870019b1,513e1a98fdc9f0358700925b,livelier,2,0,2
513d56affdc9f0358700301c,514146f1fdc9f04926006930,safer,2,0,2
513d56bafdc9f0358700302e,51422d73fdc9f04926008c1e,livelier,2,0,2
513d56bafdc9f0358700302e,51422d73fdc9f04926008c1e,safer,2,0,2
513d56cefdc9f03587003051,51414bcafdc9f0492600718a,wealthier,0,2,2
513d56d2fdc9f03587003057,513d9fb1fdc9f035870087cc,safer,2,0,2
513d56e4fdc9f03587003073,5141347cfdc9f04926004692,livelier,2,0,2
513cc5a2fdc9f0358700189b,513d34d1fdc9f03587002a6c,safer,0,2,2
513cc5b0fdc9f035870018a9,5140ce70fdc9f04926003048,more depressing,0,2,2
513cc5c0fdc9f035870018b6,513d7dcbfdc9f03587007285,wealthier,2,0,2
513cc5d6fdc9f035870018ca,5140d89efdc9f04926003a4f,more boring,2,0,2
513cc5defdc9f035870018cf,513e1d11fdc9f035870098d8,more beautiful,0,2,2
513cc634fdc9f03587001919,513f2b1dfdc9f0358700d64c,wealthier,0,2,2
513cc1d6fdc9f035870014f1,51414efffdc9f049260079a9,safer,0,2,2
513cc1ecfdc9f03587001503,513d79c0fdc9f035870065ce,more beautiful,2,0,2
513cc1f6fdc9f0358700150e,513e200ffdc9f0358700a0d6,safer,2,0,2
513cc278fdc9f03587001591,513e205afdc9f0358700a19e,safer,2,0,2
513cc296fdc9f035870015aa,5141413ffdc9f0492600617f,safer,2,0,2
513cc2b4fdc9f035870015c8,51413c0cfdc9f04926005aa9,more depressing,2,0,2
513d59a7fdc9f035870033a7,513d6a3dfdc9f035870049dc,more beautiful,2,0,2
513d5948fdc9f0358700337b,5140b7b3fdc9f04926001a9a,livelier,0,2,2
513d595dfdc9f03587003382,513d7bd7fdc9f03587006ccb,more boring,2,0,2
513cc162fdc9f03587001485,513f1367fdc9f0358700cadc,livelier,0,2,2
513cc164fdc9f03587001486,513d7d27fdc9f03587007115,more beautiful,0,2,2
513cc176fdc9f0358700149a,513d60dcfdc9f03587003d90,wealthier,2,0,2
513cc1b2fdc9f035870014d0,513da025fdc9f035870088e7,livelier,2,0,2
513cc1bafdc9f035870014d7,513f29cbfdc9f0358700d420,livelier,0,2,2
513d580efdc9f0358700328e,5140cb3ffdc9f04926002ac5,safer,2,0,2
513d585dfdc9f035870032eb,513e64d9fdc9f0358700b8b5,safer,0,2,2
513d58bffdc9f03587003322,5140c9cafdc9f04926002638,more depressing,0,2,2
513d58e7fdc9f03587003341,514134cefdc9f049260047bf,more boring,2,0,2
513d5907fdc9f03587003356,513e1d2ffdc9f0358700992b,livelier,2,0,2
513d590ffdc9f0358700335b,513d7bdffdc9f03587006ce8,more beautiful,0,2,2
513d57b0fdc9f035870031e0,51408b38fdc9f0358700e8b4,safer,2,0,2
513d57c5fdc9f0358700320c,513e64d8fdc9f0358700b8b3,more beautiful,0,2,2
513d57e4fdc9f03587003240,513d9de4fdc9f03587008219,more boring,2,0,2
513d57eafdc9f0358700324f,513d6b08fdc9f03587004c09,livelier,0,2,2
513d57effdc9f03587003259,513e6236fdc9f0358700b674,livelier,2,0,2
513d5801fdc9f03587003276,513d79b3fdc9f035870065ab,safer,2,0,2
513d5806fdc9f03587003281,51422a06fdc9f049260088cd,safer,0,2,2
513cc064fdc9f0358700138a,513e2316fdc9f0358700a627,livelier,2,0,2
513cc0aafdc9f035870013d2,5185d11dfdc9f03fd500109b,wealthier,2,0,2
513cc0b0fdc9f035870013db,513d7bcefdc9f03587006cae,livelier,2,0,2
513cc0b0fdc9f035870013db,513d7d84fdc9f035870071f1,livelier,0,2,2
513cc0c2fdc9f035870013ea,513e5c81fdc9f0358700ab32,livelier,2,0,2
513cc0e2fdc9f0358700140b,513d7b82fdc9f03587006bbb,safer,0,2,2
513cbda1fdc9f035870010d9,5140b6a0fdc9f04926001799,safer,0,2,2
513cbe20fdc9f0358700114e,5140cc0bfdc9f04926002cdd,wealthier,2,0,2
513cc010fdc9f03587001339,51414e63fdc9f0492600782f,livelier,2,0,2
513cc01efdc9f03587001348,51408ff2fdc9f049260001c3,more boring,2,0,2
513cc042fdc9f03587001369,51409503fdc9f04926000929,safer,2,0,2
513cc046fdc9f0358700136c,513d9e4ffdc9f03587008383,wealthier,2,0,2
513cc054fdc9f03587001379,513d7ed3fdc9f035870074b1,livelier,0,2,2
513cc056fdc9f0358700137d,51421b22fdc9f04926008406,more depressing,0,2,2
513cc060fdc9f03587001387,513f14eefdc9f0358700cd01,more depressing,2,0,2
513cbfb6fdc9f035870012df,513d5f86fdc9f03587003bdc,more depressing,2,0,2
513cbfdcfdc9f03587001308,513e5e64fdc9f0358700b060,wealthier,0,2,2
513cbfe6fdc9f03587001312,514089b4fdc9f0358700e58f,more boring,2,0,2
513cbfeefdc9f0358700131b,513f2dfbfdc9f0358700db2f,livelier,2,0,2
513cbff6fdc9f03587001322,5140daadfdc9f04926003e09,safer,0,2,2
513cbffafdc9f03587001327,513d77edfdc9f03587005fc9,livelier,2,0,2
513d5ae8fdc9f03587003440,513d6e21fdc9f03587005274,more boring,2,0,2
513d5b19fdc9f0358700349a,5185d11bfdc9f03fd5001098,livelier,2,0,2
513d5b35fdc9f035870034cf,513d9d49fdc9f03587008003,more beautiful,2,0,2
513d5b7afdc9f03587003551,513d9ed5fdc9f03587008536,livelier,0,2,2
513d5c30fdc9f0358700368b,513f2dd4fdc9f0358700dae5,more boring,2,0,2
513d5c35fdc9f03587003693,51414010fdc9f04926006060,more beautiful,2,0,2
513cbbd2fdc9f03587000f2e,51422840fdc9f0492600873e,more depressing,0,2,2
513cbc1afdc9f03587000f6e,513e1d3afdc9f03587009947,safer,2,0,2
513cbc20fdc9f03587000f73,513e1dd1fdc9f03587009ad0,more beautiful,0,2,2
513cbc38fdc9f03587000f8a,51414ad2fdc9f04926006fe7,safer,0,2,2
513cbc50fdc9f03587000fa3,51409022fdc9f04926000223,more depressing,0,2,2
513cbc64fdc9f03587000fb3,5185cc45fdc9f03fd5000c01,wealthier,2,0,2
513d5d19fdc9f03587003827,513d7893fdc9f035870061f2,safer,0,2,2
513d5d2bfdc9f03587003844,514094f0fdc9f04926000914,safer,0,2,2
513d5d45fdc9f03587003871,513d9c20fdc9f03587007c2e,livelier,2,0,2
513d5d4bfdc9f0358700387f,5140c8f8fdc9f049260023cb,safer,0,2,2
513d5d4efdc9f03587003884,513d9c4afdc9f03587007cb7,livelier,2,0,2
513d5d4ffdc9f03587003887,513e209cfdc9f0358700a255,wealthier,0,2,2
513d5d55fdc9f03587003892,513d9e2ffdc9f03587008316,wealthier,2,0,2
513d5d5afdc9f0358700389d,513d6b4bfdc9f03587004cad,livelier,0,2,2
513cbf88fdc9f035870012b2,513e5d29fdc9f0358700ad05,livelier,2,0,2
513cbf9cfdc9f035870012c4,51422a4ffdc9f0492600891b,livelier,0,2,2
513d5c79fdc9f03587003715,513d6c23fdc9f03587004ec5,livelier,0,2,2
513d5c81fdc9f03587003723,51414e62fdc9f0492600782b,livelier,0,2,2
513d5ca5fdc9f03587003761,5140cb91fdc9f04926002bc5,safer,0,2,2
513d5cf0fdc9f035870037e4,513e61f2fdc9f0358700b611,safer,2,0,2
513cbeb4fdc9f035870011df,513e1d02fdc9f035870098b8,more beautiful,0,2,2
513cbf07fdc9f03587001228,513e1fecfdc9f0358700a078,safer,0,2,2
513cbf20fdc9f03587001243,51413baafdc9f049260059f6,more boring,0,2,2
513cbf26fdc9f03587001248,513e1ab1fdc9f03587009298,safer,2,0,2
513d5e41fdc9f03587003a38,51408bfdfdc9f0358700ea39,wealthier,2,0,2
513d5e67fdc9f03587003a6b,5141427bfdc9f049260062d0,safer,2,0,2
513d5e7efdc9f03587003a8b,5140ba1dfdc9f04926001f73,wealthier,2,0,2
513d5e8efdc9f03587003aa2,513e6ff0fdc9f0358700c63b,more boring,0,2,2
513cb6b4fdc9f03587000a76,51413652fdc9f04926004c33,safer,0,2,2
513cb752fdc9f03587000b04,513f1302fdc9f0358700ca56,livelier,0,2,2
513cbbb2fdc9f03587000f0e,5140d305fdc9f04926003366,wealthier,0,2,2
513d5d7dfdc9f035870038db,513d6ce5fdc9f03587005074,wealthier,0,2,2
513d5ddffdc9f03587003983,513d68a0fdc9f0358700443f,more beautiful,0,2,2
513d5ddffdc9f03587003983,5141389bfdc9f0492600526c,livelier,2,0,2
513d5e13fdc9f035870039dd,5140cc4cfdc9f04926002d78,livelier,0,2,2
513d5e2cfdc9f03587003a13,5141357dfdc9f04926004a16,more depressing,2,0,2
513cb920fdc9f03587000caf,513d3610fdc9f03587002b5b,wealthier,2,0,2
513cb954fdc9f03587000cdc,5185ce7dfdc9f03fd5000e36,safer,2,0,2
513cba02fdc9f03587000d82,513d5907fdc9f03587003356,safer,0,2,2
513cba24fdc9f03587000da0,513cc422fdc9f0358700172d,safer,0,2,2
513cbad0fdc9f03587000e3b,513e60dcfdc9f0358700b471,more depressing,0,2,2
513cbc68fdc9f03587000fb8,5141331ffdc9f049260041c9,more beautiful,0,2,2
513cbc82fdc9f03587000fd2,51414eebfdc9f04926007972,livelier,0,2,2
513cbcc6fdc9f03587001013,514147b1fdc9f04926006af0,livelier,0,2,2
513cbd08fdc9f03587001044,5140ccaffdc9f04926002e69,more beautiful,0,2,2
513cbd78fdc9f035870010af,513d6b42fdc9f03587004c97,more boring,0,2,2
513cb910fdc9f03587000ca0,51421830fdc9f049260080f2,livelier,2,0,2
513cb50afdc9f035870008d0,514089dcfdc9f0358700e5e2,livelier,0,2,2
513cb527fdc9f035870008f1,5140c978fdc9f04926002547,more boring,0,2,2
513cb5aafdc9f03587000972,513f111dfdc9f0358700c7c3,safer,2,0,2
513cb640fdc9f03587000a0e,513d9ad8fdc9f0358700780d,safer,0,2,2
513cb640fdc9f03587000a0e,51409a22fdc9f04926000ee4,livelier,2,0,2
513cb65cfdc9f03587000a27,5141404bfdc9f0492600609b,wealthier,0,2,2
513d5fecfdc9f03587003c5c,51421780fdc9f0492600802f,livelier,2,0,2
513d6021fdc9f03587003c9b,51414d2afdc9f04926007502,more beautiful,0,2,2
513d6034fdc9f03587003cb8,5185d2bdfdc9f03fd5001225,wealthier,2,0,2
513d606efdc9f03587003d05,51408b83fdc9f0358700e94f,livelier,0,2,2
513cb30afdc9f035870006eb,513e2112fdc9f0358700a38e,more boring,0,2,2
513cb316fdc9f035870006fb,513d6b64fdc9f03587004ceb,wealthier,0,2,2
513cb326fdc9f03587000707,5140c8d5fdc9f04926002361,more beautiful,0,2,2
513cb352fdc9f0358700072e,51409e22fdc9f049260013cf,safer,2,0,2
513d5ecffdc9f03587003afc,513d796efdc9f035870064c5,livelier,2,0,2
513d5edefdc9f03587003b0f,513e6f6bfdc9f0358700c582,more beautiful,2,0,2
513d5ee9fdc9f03587003b1a,513f3064fdc9f0358700dec8,livelier,0,2,2
513d5f35fdc9f03587003b78,51413b08fdc9f04926005869,wealthier,0,2,2
513d5f86fdc9f03587003bdc,51414e10fdc9f04926007752,more beautiful,0,2,2
513d5f9cfdc9f03587003bf9,513e1bb0fdc9f03587009534,safer,0,2,2
513d5fb0fdc9f03587003c14,51422c25fdc9f04926008adf,wealthier,2,0,2
513d5fb4fdc9f03587003c19,513d9b55fdc9f035870079a5,more depressing,0,2,2
513cb7bdfdc9f03587000b60,513d9d7cfdc9f035870080b3,safer,2,0,2
513cb7dafdc9f03587000b7a,513d7a67fdc9f03587006804,livelier,0,2,2
513cb85cfdc9f03587000bf1,513e1d79fdc9f035870099f1,more beautiful,2,0,2
513cb884fdc9f03587000c1e,513e1e61fdc9f03587009c4e,livelier,2,0,2
513cb8c0fdc9f03587000c58,513d6a4cfdc9f03587004a11,wealthier,2,0,2
513cb8cefdc9f03587000c65,513f2f4dfdc9f0358700dd61,more depressing,2,0,2
513cb8e4fdc9f03587000c78,513d9e67fdc9f035870083cb,more depressing,0,2,2
513d5ecefdc9f03587003afa,513d790ffdc9f0358700639f,safer,0,2,2
50f61679beb2fed9100008ea,513e6d63fdc9f0358700c2b6,safer,2,0,2
50f6167abeb2fed910000905,513cb326fdc9f03587000707,livelier,0,2,2
50f6167cbeb2fed910000917,513f1356fdc9f0358700cac6,safer,0,2,2
50f6167fbeb2fed91000094d,513cb910fdc9f03587000ca1,safer,0,2,2
50f61681beb2fed91000096d,513ce01dfdc9f03587002149,safer,2,0,2
50f61682beb2fed91000096e,514135f7fdc9f04926004ba3,safer,2,0,2
50f61683beb2fed910000985,51409c2bfdc9f04926001171,more depressing,0,2,2
50f61683beb2fed91000098d,5140d2fbfdc9f0492600335d,safer,0,2,2
513d60b3fdc9f03587003d5f,513f2e1ffdc9f0358700db65,wealthier,0,2,2
513d60bbfdc9f03587003d68,514094dffdc9f04926000900,more depressing,2,0,2
513d615afdc9f03587003e23,513e622dfdc9f0358700b667,livelier,0,2,2
513d6185fdc9f03587003e5a,513e6046fdc9f0358700b386,safer,0,2,2
513d61a9fdc9f03587003e8d,513f13ccfdc9f0358700cb63,livelier,2,0,2
513d61b5fdc9f03587003e9c,513f10d5fdc9f0358700c766,livelier,0,2,2
513d61b9fdc9f03587003ea0,513e5fd8fdc9f0358700b2d8,more boring,0,2,2
51392ae4818ede12960011ad,5185ce81fdc9f03fd5000e3a,wealthier,2,0,2
51392bbe818ede12960011e7,513d5878fdc9f035870032fc,livelier,0,2,2
51392d1e818ede1296001240,513e5f19fdc9f0358700b1c0,more depressing,2,0,2
51392e12818ede1296001288,513cbfd6fdc9f03587001301,wealthier,2,0,2
513cb2b3fdc9f03587000699,513d5d99fdc9f0358700390f,livelier,0,2,2
513d607efdc9f03587003d17,51409928fdc9f04926000d9d,safer,0,2,2
513d6088fdc9f03587003d25,513e5ea7fdc9f0358700b10d,more boring,2,0,2
513d60a7fdc9f03587003d50,513e60a8fdc9f0358700b41f,more depressing,0,2,2
513927d6818ede12960010d6,51408bd9fdc9f0358700e9fa,more beautiful,0,2,2
51392970818ede1296001147,5140d20ffdc9f0492600327f,livelier,0,2,2
5139297c818ede129600114b,513e1d05fdc9f035870098c2,safer,0,2,2
51392980818ede129600114c,513f2931fdc9f0358700d30a,more beautiful,2,0,2
51392a6e818ede129600118b,51415059fdc9f04926007d0f,more depressing,2,0,2
50f61463beb2fed9100007b2,51408940fdc9f0358700e49b,more beautiful,2,0,2
50f61668beb2fed9100007d1,51414cd7fdc9f04926007428,more boring,0,2,2
50f6166bbeb2fed9100007fd,51413b8afdc9f049260059ab,livelier,0,2,2
50f6166ebeb2fed91000082f,513e1ddafdc9f03587009ae6,wealthier,2,0,2
50f6166fbeb2fed910000846,514135cffdc9f04926004b43,more beautiful,0,2,2
50f61673beb2fed910000883,513d9d30fdc9f03587007faf,safer,0,2,2
50f61674beb2fed91000089f,51414e70fdc9f0492600784f,safer,0,2,2
513d680ffdc9f03587004237,513d689dfdc9f0358700442f,more beautiful,2,0,2
513d6833fdc9f035870042b2,5140d8bcfdc9f04926003a92,more beautiful,0,2,2
513d6840fdc9f035870042e6,513f29e1fdc9f0358700d445,more beautiful,2,0,2
513d6846fdc9f035870042fb,513e1addfdc9f03587009300,livelier,2,0,2
513d684dfdc9f03587004311,513e1c03fdc9f03587009614,safer,2,0,2
50f61460beb2fed910000777,513d796afdc9f035870064ba,wealthier,2,0,2
50f61461beb2fed910000785,5140d7c2fdc9f04926003896,livelier,0,2,2
513d622afdc9f03587003f33,51414dc5fdc9f0492600769b,safer,2,0,2
513d6783fdc9f035870040c4,513f28a0fdc9f0358700d21f,livelier,2,0,2
513d678efdc9f035870040e3,513d9eb0fdc9f035870084bb,livelier,0,2,2
513d6796fdc9f035870040f5,513d7b35fdc9f03587006aaa,safer,2,0,2
513d679cfdc9f03587004105,51408ba3fdc9f0358700e98a,more beautiful,2,0,2
513d67a8fdc9f03587004127,51413a9ffdc9f04926005763,safer,2,0,2
513d67c4fdc9f03587004166,513e60bcfdc9f0358700b43d,more beautiful,2,0,2
513d67cbfdc9f03587004177,5140b938fdc9f04926001ddf,livelier,2,0,2
5139248c818ede1296000ff6,513f1117fdc9f0358700c7bb,wealthier,2,0,2
51392560818ede1296001032,51413784fdc9f04926004f52,safer,2,0,2
51392570818ede1296001036,51413b3efdc9f049260058f4,more boring,2,0,2
513926b6818ede1296001088,513cb886fdc9f03587000c20,livelier,0,2,2
513926c4818ede129600108d,513da00ffdc9f035870088ab,safer,2,0,2
51392728818ede12960010a8,51422908fdc9f04926008802,more boring,2,0,2
513d68b0fdc9f03587004472,513d7a9bfdc9f035870068c2,livelier,2,0,2
513d68b3fdc9f0358700447d,5140c95ffdc9f049260024fa,more beautiful,0,2,2
513d68c6fdc9f035870044c3,51414eacfdc9f049260078e5,more beautiful,2,0,2
513d68d2fdc9f035870044e7,513d7ec1fdc9f03587007489,safer,2,0,2
513d68defdc9f03587004511,513e60c6fdc9f0358700b44c,livelier,2,0,2
50f60c41beb2fed910000174,51413c4cfdc9f04926005af7,safer,0,2,2
50f60c42beb2fed910000190,50f60c4dbeb2fed91000028b,wealthier,0,2,2
50f60c45beb2fed9100001d7,513cc6cafdc9f035870019aa,more beautiful,0,2,2
50f6145fbeb2fed910000763,51421b87fdc9f04926008472,livelier,0,2,2
513d686ffdc9f03587004383,5140ca5bfdc9f049260027f4,safer,2,0,2
513d6874fdc9f03587004395,51408a2cfdc9f0358700e68e,more depressing,0,2,2
513d6877fdc9f035870043a4,51413452fdc9f049260045fb,more beautiful,0,2,2
513d687afdc9f035870043ad,513f29c6fdc9f0358700d414,wealthier,0,2,2
513d6884fdc9f035870043d4,5140cc6cfdc9f04926002dc6,safer,2,0,2
513d6896fdc9f0358700440e,513d79eafdc9f0358700665c,safer,2,0,2
513d6896fdc9f03587004411,51409b6efdc9f0492600108c,wealthier,2,0,2
50f60e73beb2fed910000665,513d6c67fdc9f03587004f71,safer,0,2,2
50f60e75beb2fed910000689,513cbfb8fdc9f035870012e1,more beautiful,2,0,2
50f61456beb2fed9100006de,5140b727fdc9f0492600190e,safer,0,2,2
50f61457beb2fed9100006f1,513d7b72fdc9f03587006b81,livelier,0,2,2
50f6145abeb2fed910000719,513cc930fdc9f03587001be7,wealthier,2,0,2
50f6145bbeb2fed91000072f,51421b40fdc9f04926008429,more depressing,2,0,2
50f61675beb2fed9100008b8,51414f12fdc9f049260079da,livelier,2,0,2
50f61676beb2fed9100008ce,513e5c94fdc9f0358700ab69,livelier,2,0,2
50f60c55beb2fed910000316,513e1a9bfdc9f03587009261,safer,2,0,2
50f60c58beb2fed91000033b,51409906fdc9f04926000d6f,livelier,0,2,2
50f60e6fbeb2fed910000612,51422902fdc9f049260087fc,livelier,2,0,2
50f60e70beb2fed91000061d,5142174bfdc9f04926007ff9,livelier,0,2,2
50f60e71beb2fed91000062f,51414f99fdc9f04926007b2d,more depressing,0,2,2
50f60e73beb2fed910000665,513cc8befdc9f03587001b7a,livelier,0,2,2
50f60b8bbeb2fed91000002b,51414854fdc9f04926006c81,livelier,0,2,2
50f60b8bbeb2fed910000030,513d2d20fdc9f0358700249e,safer,0,2,2
50f60b8bbeb2fed910000033,513cc060fdc9f03587001387,livelier,0,2,2
50f60b8dbeb2fed910000056,514217b1fdc9f0492600806a,more beautiful,2,0,2
50f60b8dbeb2fed910000058,513d683bfdc9f035870042d0,wealthier,2,0,2
50f60b8ebeb2fed910000066,5140caf8fdc9f049260029e1,more beautiful,2,0,2
50f60b8ebeb2fed91000006a,513e5f9ffdc9f0358700b282,more depressing,2,0,2
513d695cfdc9f035870046d6,51413333fdc9f0492600420e,wealthier,0,2,2
513d6964fdc9f035870046f0,513e6f8dfdc9f0358700c5b6,safer,2,0,2
513d6967fdc9f035870046fa,514091d0fdc9f049260005ae,safer,0,2,2
513d6977fdc9f03587004738,5140b9a4fdc9f04926001eb3,more depressing,0,2,2
513d6978fdc9f0358700473c,513e1e4bfdc9f03587009c11,safer,0,2,2
50f60b89beb2fed91000001c,513e6c96fdc9f0358700c1ab,wealthier,2,0,2
50f60b8abeb2fed910000023,513d9deffdc9f0358700823f,safer,2,0,2
50f60c51beb2fed9100002d4,513e6da1fdc9f0358700c30f,livelier,0,2,2
50f60c52beb2fed9100002ed,513e6ba6fdc9f0358700c06b,safer,2,0,2
50f60c54beb2fed910000301,5185cfc5fdc9f03fd5000f82,livelier,2,0,2
513d68f2fdc9f0358700455c,5140c93bfdc9f0492600248c,more beautiful,2,0,2
513d6909fdc9f035870045ac,514139cbfdc9f04926005555,safer,2,0,2
513d690afdc9f035870045ae,513e205cfdc9f0358700a1a4,more depressing,2,0,2
513d6929fdc9f0358700462a,5140ca67fdc9f0492600281b,wealthier,0,2,2
513d6935fdc9f03587004656,513e5d21fdc9f0358700acee,safer,2,0,2
50f60c45beb2fed9100001d7,513cc6cafdc9f035870019aa,wealthier,0,2,2
50f60c46beb2fed9100001e6,513ced25fdc9f035870023c7,livelier,2,0,2
50f60c47beb2fed9100001fe,51408f77fdc9f049260000d6,livelier,0,2,2
50f60c49beb2fed910000234,513e6dd5fdc9f0358700c357,more beautiful,2,0,2
50f60c49beb2fed910000235,513d781bfdc9f03587006055,livelier,0,2,2
50f60c4cbeb2fed910000267,513cc9aafdc9f03587001c54,safer,2,0,2
50f60c50beb2fed9100002c0,513d7de1fdc9f035870072b6,more depressing,2,0,2
50f60872beb2fed6f80004d8,514140a6fdc9f049260060ee,livelier,0,2,2
50f60874beb2fed6f80004f4,514151a3fdc9f04926007fd1,livelier,2,0,2
50f60875beb2fed6f8000511,5140d582fdc9f049260034d4,wealthier,0,2,2
50f60875beb2fed6f8000519,513e1be2fdc9f035870095b9,more boring,2,0,2
50f60877beb2fed6f8000533,513f2c04fdc9f0358700d7d2,safer,0,2,2
50f60878beb2fed6f800054f,513e6426fdc9f0358700b7b9,safer,2,0,2
513d6a25fdc9f0358700498c,51413473fdc9f04926004674,safer,0,2,2
513d6a27fdc9f03587004995,51421a6efdc9f04926008340,livelier,2,0,2
513d6a05fdc9f0358700491a,51408cbafdc9f0358700eba9,livelier,2,0,2
513d6a0efdc9f0358700493c,513d6b04fdc9f03587004bfd,wealthier,2,0,2
50f60867beb2fed6f80003ee,513f2b88fdc9f0358700d6f7,more depressing,2,0,2
50f60867beb2fed6f80003f0,513d9bfbfdc9f03587007bb5,more depressing,0,2,2
50f6086fbeb2fed6f80004a0,513f2ee3fdc9f0358700dcbe,more beautiful,0,2,2
513d6992fdc9f03587004799,5185d3b1fdc9f03fd500130f,safer,0,2,2
513d6993fdc9f0358700479a,513e1ae6fdc9f03587009317,more boring,0,2,2
513d69a7fdc9f035870047e3,51409dcbfdc9f04926001367,safer,0,2,2
513d69a7fdc9f035870047e4,5140b6affdc9f049260017bd,safer,2,0,2
513d69e9fdc9f035870048c3,513d6b9afdc9f03587004d70,more depressing,2,0,2
513d69f2fdc9f035870048e0,513e1af5fdc9f0358700933b,livelier,0,2,2
50f60b8ebeb2fed910000070,514133d9fdc9f04926004450,safer,2,0,2
50f60b91beb2fed910000095,5140927efdc9f049260006b4,safer,2,0,2
50f60b96beb2fed9100000d0,513d5caffdc9f03587003773,more depressing,0,2,2
50f60b96beb2fed9100000df,513cc1d4fdc9f035870014ef,safer,2,0,2
50f60b98beb2fed9100000fb,51408babfdc9f0358700e999,more depressing,0,2,2
50f60c40beb2fed91000016a,513e2155fdc9f0358700a41d,more boring,0,2,2
513d6980fdc9f0358700475e,513e1f9efdc9f03587009f9c,more boring,2,0,2
513d6982fdc9f03587004764,5140906ffdc9f049260002ca,safer,0,2,2
50f607dabeb2fed6f8000323,5185d362fdc9f03fd50012bf,safer,0,2,2
50f607dbbeb2fed6f8000328,513d5ccbfdc9f035870037a0,safer,0,2,2
50f607debeb2fed6f8000364,5140b730fdc9f04926001929,more beautiful,0,2,2
50f607e1beb2fed6f800038d,513e64d1fdc9f0358700b8ab,more boring,0,2,2
50f607e3beb2fed6f80003bf,513e5d3dfdc9f0358700ad35,more beautiful,2,0,2
513d6acefdc9f03587004b73,51408f50fdc9f04926000086,more depressing,2,0,2
513d6ae8fdc9f03587004bb3,513e6caefdc9f0358700c1c9,livelier,2,0,2
50f607d4beb2fed6f80002ad,50f60b9abeb2fed91000013f,more depressing,0,2,2
50f607d5beb2fed6f80002b6,513f2da5fdc9f0358700da8d,livelier,0,2,2
50f607d6beb2fed6f80002d6,51414618fdc9f04926006729,safer,2,0,2
50f607d9beb2fed6f800030c,513f2d99fdc9f0358700da7d,safer,0,2,2
50f607dabeb2fed6f8000316,513d5facfdc9f03587003c0e,livelier,2,0,2
50f607dabeb2fed6f8000316,51409841fdc9f04926000c6d,safer,0,2,2
513d6a93fdc9f03587004ad5,51414d4cfdc9f04926007560,safer,0,2,2
513d6ab0fdc9f03587004b26,513d9b4afdc9f03587007981,livelier,2,0,2
513d6ab5fdc9f03587004b32,51414c1dfdc9f04926007256,livelier,0,2,2
50f607cfbeb2fed6f8000244,513d9c5bfdc9f03587007ced,more beautiful,2,0,2
50f607cfbeb2fed6f800024b,513cb508fdc9f035870008cd,safer,0,2,2
50f607d1beb2fed6f8000272,514217dffdc9f04926008096,safer,0,2,2
513d6a2dfdc9f035870049ab,513e5de1fdc9f0358700af00,more beautiful,2,0,2
513d6a40fdc9f035870049e9,51413693fdc9f04926004c87,wealthier,0,2,2
513d6a54fdc9f03587004a29,51408a68fdc9f0358700e703,safer,0,2,2
513d6a5cfdc9f03587004a46,514139bafdc9f04926005533,livelier,0,2,2
513d6a5dfdc9f03587004a49,513d7a60fdc9f035870067ee,safer,0,2,2
513d6a68fdc9f03587004a63,5140b890fdc9f04926001c91,livelier,0,2,2
513d6a7afdc9f03587004a95,5140b770fdc9f049260019d9,safer,0,2,2
513d6a81fdc9f03587004aa6,51414773fdc9f04926006a64,livelier,2,0,2
50f5eeecfdc9f065f000910c,5140d96cfdc9f04926003be6,wealthier,0,2,2
50f5eeedfdc9f065f0009126,513ceb49fdc9f03587002363,wealthier,2,0,2
50f5eeedfdc9f065f0009128,513e5d39fdc9f0358700ad2e,safer,2,0,2
50f60120beb2fed6f80001ab,5140ca91fdc9f0492600289e,safer,2,0,2
50f60121beb2fed6f80001c1,513d9b3afdc9f03587007940,livelier,0,2,2
50f607ccbeb2fed6f8000206,513e1c35fdc9f035870096a2,livelier,0,2,2
50f607cdbeb2fed6f800021a,513e1d65fdc9f035870099ba,safer,0,2,2
513d6ba2fdc9f03587004d84,513d7b18fdc9f03587006a4f,more beautiful,2,0,2
50f5eee7fdc9f065f0009082,51413bc5fdc9f04926005a3a,more boring,0,2,2
50f5eee7fdc9f065f000908e,513f138cfdc9f0358700cb0f,livelier,0,2,2
50f5eee8fdc9f065f000909c,513d6d2afdc9f035870050e5,more beautiful,2,0,2
50f5eee8fdc9f065f00090ad,513cbea2fdc9f035870011cd,wealthier,0,2,2
50f5eeeafdc9f065f00090e0,50f60c58beb2fed91000033c,wealthier,0,2,2
50f5eeecfdc9f065f000910b,513d7d41fdc9f03587007164,safer,2,0,2
513d6b3afdc9f03587004c88,5140cbc4fdc9f04926002c46,livelier,0,2,2
513d6b49fdc9f03587004ca9,51409b0ffdc9f0492600100b,safer,0,2,2
513d6b50fdc9f03587004cb9,513f2e86fdc9f0358700dc1f,more beautiful,2,0,2
513d6b5cfdc9f03587004cd5,51414c8efdc9f04926007374,wealthier,0,2,2
513d6b91fdc9f03587004d57,5185cc45fdc9f03fd5000c00,safer,2,0,2
513d6b96fdc9f03587004d63,513f2d5cfdc9f0358700da12,wealthier,0,2,2
513d6ba0fdc9f03587004d80,51413ae3fdc9f0492600580d,safer,2,0,2
513d6af4fdc9f03587004bd6,513e6c92fdc9f0358700c1a8,livelier,2,0,2
513d6afbfdc9f03587004be1,5142287dfdc9f04926008773,safer,2,0,2
513d6b0cfdc9f03587004c15,51409499fdc9f049260008bc,safer,2,0,2
513d6b1ffdc9f03587004c47,513e1d30fdc9f0358700992f,safer,0,2,2
513d6b2cfdc9f03587004c6a,51409852fdc9f04926000c7e,safer,0,2,2
513d6b36fdc9f03587004c7c,513e61f1fdc9f0358700b610,safer,0,2,2
513d6c29fdc9f03587004ed2,514134ddfdc9f049260047f3,livelier,2,0,2
513d6c30fdc9f03587004ee6,513f13e1fdc9f0358700cb81,livelier,2,0,2
513d6c3afdc9f03587004eff,514139e1fdc9f04926005586,safer,0,2,2
513d6c43fdc9f03587004f15,514218e9fdc9f049260081b1,safer,0,2,2
513d6c49fdc9f03587004f23,513d7999fdc9f0358700655c,wealthier,0,2,2
50f5ed6afdc9f065f0008d53,513d9debfdc9f03587008231,livelier,2,0,2
50f5ed6afdc9f065f0008d5f,514217f8fdc9f049260080b7,more beautiful,0,2,2
50f5ed6bfdc9f065f0008d6d,513d6a78fdc9f03587004a8f,livelier,2,0,2
513d6bbefdc9f03587004dc0,513f2fedfdc9f0358700de66,wealthier,2,0,2
513d6bcafdc9f03587004dde,5140b9a7fdc9f04926001ebe,safer,2,0,2
513d6bcefdc9f03587004deb,51414e42fdc9f049260077cf,more boring,2,0,2
513d6be0fdc9f03587004e1c,513d6c85fdc9f03587004fb3,safer,0,2,2
513d6be2fdc9f03587004e1e,51421ccafdc9f049260085d2,more depressing,2,0,2
513d6bebfdc9f03587004e37,513f2cd8fdc9f0358700d932,livelier,0,2,2
513d6c15fdc9f03587004e9c,5141357afdc9f04926004a02,more depressing,2,0,2
513d6c18fdc9f03587004ea6,51414812fdc9f04926006bdd,safer,0,2,2
50f5eeaffdc9f065f0008fe3,51409809fdc9f04926000c1e,more depressing,0,2,2
50f5eeaffdc9f065f0008fe7,513d5ea1fdc9f03587003ab9,more boring,0,2,2
50f5eeaffdc9f065f0008ff9,513f14ebfdc9f0358700ccfc,more boring,0,2,2
50f5eeb1fdc9f065f000901a,513ceec9fdc9f0358700240e,livelier,2,0,2
50f5eeb2fdc9f065f0009035,513d77f1fdc9f03587005fd4,more beautiful,2,0,2
513d6ba2fdc9f03587004d84,5140b726fdc9f0492600190d,livelier,0,2,2
513d6ba7fdc9f03587004d92,514135eafdc9f04926004b84,more beautiful,2,0,2
50f5ee96fdc9f065f0008ee8,513924c8818ede1296001009,more beautiful,0,2,2
50f5ee99fdc9f065f0008f28,513d6904fdc9f03587004599,more depressing,0,2,2
50f5ee9bfdc9f065f0008f55,513e60e7fdc9f0358700b484,livelier,2,0,2
50f5eeabfdc9f065f0008f85,51422b00fdc9f049260089ce,livelier,0,2,2
50f5eeacfdc9f065f0008fab,513f29a0fdc9f0358700d3d3,more depressing,0,2,2
50f5eeaefdc9f065f0008fdd,513d5d5efdc9f035870038a3,safer,2,0,2
50f5eeaefdc9f065f0008fe0,514147d0fdc9f04926006b3e,more depressing,2,0,2
513d6dcbfdc9f035870051ea,5140891dfdc9f0358700e447,more depressing,0,2,2
50f5ecf5fdc9f065f0008bb1,51408a1cfdc9f0358700e670,wealthier,2,0,2
50f5ed55fdc9f065f0008c12,51414ebdfdc9f04926007902,livelier,0,2,2
50f5ed56fdc9f065f0008c30,513d7a2bfdc9f0358700673a,livelier,2,0,2
50f5ed56fdc9f065f0008c34,513d79a5fdc9f03587006581,safer,2,0,2
50f5ed57fdc9f065f0008c43,513d57c1fdc9f03587003204,safer,2,0,2
50f5ed58fdc9f065f0008c5b,5141476ffdc9f04926006a5d,safer,2,0,2
513d6ca3fdc9f03587005003,51409831fdc9f04926000c53,more beautiful,0,2,2
513d6ca6fdc9f03587005009,5140cab4fdc9f04926002909,more depressing,0,2,2
513d6ca7fdc9f0358700500b,5185cd76fdc9f03fd5000d2f,livelier,0,2,2
513d6d21fdc9f035870050d7,513e1d14fdc9f035870098e3,more beautiful,2,0,2
513d6d47fdc9f03587005117,513f2aaffdc9f0358700d59d,wealthier,2,0,2
513d6d4afdc9f0358700511d,513d7bfbfdc9f03587006d41,safer,2,0,2
513d6d66fdc9f03587005145,51408b0cfdc9f0358700e85d,more beautiful,2,0,2
513d6d86fdc9f03587005179,51414d49fdc9f04926007553,livelier,2,0,2
513d6c7dfdc9f03587004f9f,513e6d56fdc9f0358700c2a7,more boring,0,2,2
513d6c80fdc9f03587004fa7,513e5e3bfdc9f0358700afeb,livelier,0,2,2
513d6c85fdc9f03587004fb4,513e6d39fdc9f0358700c27b,livelier,0,2,2
513d6c85fdc9f03587004fb4,5185cef1fdc9f03fd5000ea8,more depressing,0,2,2
513d6c87fdc9f03587004fb8,5185cb41fdc9f03fd5000b04,more boring,2,0,2
513d6c93fdc9f03587004fd6,513d7b59fdc9f03587006b30,safer,0,2,2
513d6c99fdc9f03587004fe8,5141434efdc9f049260063b5,livelier,2,0,2
513d6ca2fdc9f03587004fff,513d78d4fdc9f035870062d3,livelier,0,2,2
50f5ed6bfdc9f065f0008d6f,513f11ccfdc9f0358700c8a8,livelier,0,2,2
50f5ed6cfdc9f065f0008d82,513d5b56fdc9f0358700350f,wealthier,0,2,2
50f5ed96fdc9f065f0008de0,5141388bfdc9f04926005244,wealthier,0,2,2
50f5ed9afdc9f065f0008e2b,514138b7fdc9f049260052b2,livelier,0,2,2
50f5ed9cfdc9f065f0008e66,513d326efdc9f035870028b3,livelier,0,2,2
50f5ee93fdc9f065f0008e93,513d577efdc9f03587003191,livelier,2,0,2
50f5ee94fdc9f065f0008ea6,51408ca9fdc9f0358700eb85,more depressing,2,0,2
50f5ec43fdc9f065f00088ef,513d56f8fdc9f0358700309f,more boring,2,0,2
50f5ec9ffdc9f065f0008ac1,51409a2bfdc9f04926000eee,wealthier,0,2,2
50f5ecf0fdc9f065f0008b39,513e215cfdc9f0358700a426,more beautiful,2,0,2
50f5ecf1fdc9f065f0008b4e,513cc594fdc9f0358700188d,safer,0,2,2
50f5ecf2fdc9f065f0008b6e,513cb73bfdc9f03587000aef,more depressing,0,2,2
50f5ecf4fdc9f065f0008b8b,513e6444fdc9f0358700b7e2,more beautiful,2,0,2
513d781afdc9f03587006054,5140cb75fdc9f04926002b72,safer,2,0,2
513d7820fdc9f03587006066,513d78e0fdc9f03587006301,safer,2,0,2
513d7823fdc9f03587006074,513e1d5cfdc9f0358700999e,livelier,2,0,2
50f5ec3ffdc9f065f00088a4,513d34a6fdc9f03587002a49,livelier,0,2,2
50f5ec3ffdc9f065f00088a6,513f2af6fdc9f0358700d60e,more boring,0,2,2
50f5ec41fdc9f065f00088c9,513e5c9afdc9f0358700ab7d,wealthier,2,0,2
50f5ec42fdc9f065f00088de,5140ccc9fdc9f04926002e9f,more beautiful,2,0,2
50f5ed68fdc9f065f0008d23,513d7cf8fdc9f0358700707f,more beautiful,0,2,2
50f5ed68fdc9f065f0008d27,513d6909fdc9f035870045a9,wealthier,0,2,2
513d6dd6fdc9f035870051fa,51408a58fdc9f0358700e6e3,more boring,0,2,2
513d6dd8fdc9f035870051ff,513e5cf1fdc9f0358700ac62,safer,0,2,2
513d6deafdc9f0358700521e,51413d42fdc9f04926005ccf,more beautiful,0,2,2
513d6e1afdc9f0358700526a,5185ce9bfdc9f03fd5000e50,livelier,0,2,2
513d6e28fdc9f0358700527c,5140cb9cfdc9f04926002be7,more boring,0,2,2
513d6e8cfdc9f03587005315,513e1e55fdc9f03587009c2e,more beautiful,2,0,2
50f5ed5afdc9f065f0008c8f,51413653fdc9f04926004c35,safer,2,0,2
50f5ed5afdc9f065f0008c94,5140d8aafdc9f04926003a6a,livelier,2,0,2
50f5ed5afdc9f065f0008c99,50f61457beb2fed9100006ee,safer,0,2,2
50f5ed5bfdc9f065f0008ca6,50f607dabeb2fed6f8000323,livelier,0,2,2
50f5ed64fdc9f065f0008cc9,5140908afdc9f04926000302,more depressing,2,0,2
50f5ed66fdc9f065f0008cf9,513d785bfdc9f03587006136,more beautiful,2,0,2
50f5ed66fdc9f065f0008d02,513e1adbfdc9f035870092fe,more boring,0,2,2
50f5ed68fdc9f065f0008d1d,5140cba4fdc9f04926002bfd,safer,0,2,2
50f5ec36fdc9f065f00087fe,5141377cfdc9f04926004f33,livelier,0,2,2
50f5ec38fdc9f065f000881b,51414cd6fdc9f04926007423,safer,0,2,2
50f5ec3afdc9f065f0008846,513f14b4fdc9f0358700ccae,more beautiful,0,2,2
50f5ec3afdc9f065f000884a,51413b33fdc9f049260058d2,livelier,2,0,2
50f5ec3bfdc9f065f000884e,50f60e70beb2fed910000616,safer,2,0,2
50f5ec3cfdc9f065f0008864,513e6f34fdc9f0358700c53b,more boring,2,0,2
50f5ec3efdc9f065f000888b,5185d267fdc9f03fd50011d2,more depressing,2,0,2
50f5ec18fdc9f065f0008722,513d7ad8fdc9f03587006983,safer,2,0,2
50f5ec19fdc9f065f0008727,51414c77fdc9f0492600733b,livelier,0,2,2
50f5ec19fdc9f065f000872c,51409090fdc9f04926000310,livelier,2,0,2
50f5ec19fdc9f065f000872f,513e1a70fdc9f035870091ea,wealthier,0,2,2
50f5ec1afdc9f065f0008745,513d6a81fdc9f03587004aa5,safer,2,0,2
50f5ec1cfdc9f065f0008767,513ccda8fdc9f03587001d7d,wealthier,2,0,2
50f5ec1efdc9f065f0008792,5140ca20fdc9f04926002741,wealthier,0,2,2
50f5ec36fdc9f065f00087ef,513e603cfdc9f0358700b376,more beautiful,0,2,2
513d7863fdc9f03587006155,51414ec4fdc9f04926007918,more boring,2,0,2
513d786bfdc9f03587006170,513d7935fdc9f03587006419,more beautiful,0,2,2
513d7881fdc9f035870061b6,513f2f52fdc9f0358700dd6a,safer,2,0,2
513d78a4fdc9f0358700622a,514227bcfdc9f049260086b8,livelier,2,0,2
513d78acfdc9f03587006244,5140b99dfdc9f04926001ea6,livelier,2,0,2
513d78cdfdc9f035870062ba,513f10d7fdc9f0358700c76a,more boring,0,2,2
513d783afdc9f035870060c2,51414c5bfdc9f049260072fa,safer,0,2,2
513d7841fdc9f035870060dc,5140ca1efdc9f0492600273c,livelier,2,0,2
513d7841fdc9f035870060de,513d9ae8fdc9f03587007844,more beautiful,0,2,2
513d7842fdc9f035870060e0,51413b6cfdc9f0492600596a,safer,2,0,2
513d7847fdc9f035870060ee,514135ecfdc9f04926004b8c,wealthier,2,0,2
513d7855fdc9f03587006121,51413a3dfdc9f04926005671,safer,0,2,2
513d7857fdc9f03587006127,514090f9fdc9f049260003ef,safer,2,0,2
513d7863fdc9f03587006154,5185d51afdc9f03fd5001478,more boring,2,0,2
50f5ebd2fdc9f065f00085e6,513d7b12fdc9f03587006a3b,wealthier,0,2,2
50f5ebd3fdc9f065f0008606,514092e7fdc9f04926000719,more beautiful,0,2,2
50f5ebd3fdc9f065f0008609,5140d5a7fdc9f04926003521,livelier,0,2,2
50f5ebd4fdc9f065f0008616,513e1f55fdc9f03587009ed7,livelier,0,2,2
50f5ec10fdc9f065f0008681,51408994fdc9f0358700e541,livelier,2,0,2
50f5ec10fdc9f065f0008684,513f1474fdc9f0358700cc51,livelier,2,0,2
50f5ec14fdc9f065f00086d5,513d9b53fdc9f0358700799d,wealthier,2,0,2
50f5eba7fdc9f065f0008400,51422782fdc9f04926008681,more beautiful,0,2,2
50f5ebc8fdc9f065f0008518,513d2d98fdc9f035870024fd,safer,0,2,2
50f5ebc9fdc9f065f0008531,514146dffdc9f04926006902,safer,0,2,2
50f5ebccfdc9f065f0008567,513e1ca0fdc9f035870097b5,safer,0,2,2
50f5ebcffdc9f065f00085b1,513d9dd7fdc9f035870081ee,more boring,2,0,2
50f5ebd0fdc9f065f00085bf,5141481cfdc9f04926006bf4,safer,2,0,2
513d7907fdc9f0358700637f,51408c7ffdc9f0358700eb36,more boring,0,2,2
513d7908fdc9f03587006385,513e5de3fdc9f0358700af06,livelier,2,0,2
513d790afdc9f0358700638d,51409821fdc9f04926000c3a,safer,0,2,2
513d790afdc9f0358700638e,51409287fdc9f049260006bd,more beautiful,2,0,2
513d7912fdc9f035870063a7,513d7b58fdc9f03587006b28,more beautiful,0,2,2
513d7917fdc9f035870063b3,514135c1fdc9f04926004b18,safer,0,2,2
513d78e4fdc9f0358700630b,513e1fd5fdc9f0358700a03a,safer,0,2,2
513d78e9fdc9f0358700631c,5140c8fefdc9f049260023dd,safer,2,0,2
513d78edfdc9f03587006329,513d79defdc9f0358700662f,more beautiful,0,2,2
513d78f2fdc9f0358700633b,513e5e79fdc9f0358700b0a3,more beautiful,2,0,2
513d78fbfdc9f03587006356,513e1ac4fdc9f035870092c5,safer,2,0,2
513d78fcfdc9f03587006357,5140cb51fdc9f04926002b06,wealthier,0,2,2
513d7996fdc9f03587006553,513d9a79fdc9f035870076d7,safer,2,0,2
513d79b1fdc9f035870065a7,513e1c4dfdc9f035870096db,more beautiful,0,2,2
513d79b5fdc9f035870065b2,513f289afdc9f0358700d212,wealthier,2,0,2
513d79b6fdc9f035870065b4,513d9aa7fdc9f03587007764,livelier,0,2,2
513d79e9fdc9f03587006654,513e1f5bfdc9f03587009ee7,more depressing,2,0,2
513d79e9fdc9f03587006655,513da0e7fdc9f03587008a51,safer,2,0,2
513d794efdc9f03587006466,513e6ea9fdc9f0358700c478,wealthier,2,0,2
513d7958fdc9f03587006487,513e6b36fdc9f0358700bfd4,wealthier,2,0,2
513d7958fdc9f03587006488,5142292afdc9f0492600881e,livelier,2,0,2
513d795efdc9f03587006493,5185cd8afdc9f03fd5000d46,wealthier,2,0,2
513d797ffdc9f03587006505,513e5fdefdc9f0358700b2e2,safer,2,0,2
513d7992fdc9f03587006541,513f13cdfdc9f0358700cb65,wealthier,2,0,2
50f5ebaefdc9f065f0008490,5140c8d5fdc9f04926002361,livelier,0,2,2
50f5ebb0fdc9f065f00084a5,5140b78cfdc9f04926001a2c,livelier,2,0,2
50f5ebc6fdc9f065f00084f6,514090bdfdc9f04926000373,more beautiful,0,2,2
513d792cfdc9f035870063fa,5141451cfdc9f04926006594,livelier,0,2,2
513d7933fdc9f03587006411,513d9f53fdc9f035870086e2,wealthier,2,0,2
513d7939fdc9f03587006426,5140d863fdc9f049260039d7,safer,2,0,2
513d793efdc9f03587006436,5140b840fdc9f04926001be5,safer,2,0,2
50f5eba7fdc9f065f0008402,513e2118fdc9f0358700a39e,safer,2,0,2
50f5ebaafdc9f065f0008431,513cbacefdc9f03587000e39,more boring,2,0,2
50f5ebacfdc9f065f0008461,514218a3fdc9f0492600816c,more beautiful,0,2,2
50f5ebacfdc9f065f0008467,5140933efdc9f0492600076b,safer,0,2,2
50f5ebadfdc9f065f0008472,513e5f4efdc9f0358700b20b,safer,0,2,2
50f5ebaefdc9f065f000848c,513cb79efdc9f03587000b47,wealthier,0,2,2
50f5eb6efdc9f065f000832f,513f2936fdc9f0358700d30f,more beautiful,2,0,2
50f5eb71fdc9f065f000835c,513d7a70fdc9f03587006822,more depressing,2,0,2
50f5eba1fdc9f065f0008392,51422c9dfdc9f04926008b53,livelier,2,0,2
50f5eba1fdc9f065f0008397,5140d00cfdc9f049260031d7,more depressing,0,2,2
50f5eba3fdc9f065f00083ad,51414d20fdc9f049260074e6,more boring,0,2,2
50f5eba3fdc9f065f00083b9,513cb53afdc9f03587000905,wealthier,2,0,2
50f5eba5fdc9f065f00083db,513e5f45fdc9f0358700b1fb,safer,0,2,2
50f5eb64fdc9f065f0008269,51414fd7fdc9f04926007bc7,more beautiful,2,0,2
50f5eb65fdc9f065f000827c,513d5e5efdc9f03587003a5f,safer,2,0,2
50f5eb66fdc9f065f0008281,513e6d15fdc9f0358700c248,livelier,0,2,2
50f5eb69fdc9f065f00082c9,513d37e6fdc9f03587002c25,more depressing,0,2,2
50f5eb6afdc9f065f00082e2,513d9bb9fdc9f03587007adc,safer,2,0,2
50f5eb6bfdc9f065f00082ed,51422c72fdc9f04926008b2d,livelier,0,2,2
50f5eb6dfdc9f065f0008311,51408a31fdc9f0358700e698,more depressing,2,0,2
50f5eb6efdc9f065f000831c,513e6b68fdc9f0358700c015,more beautiful,0,2,2
513d7a50fdc9f035870067b4,514149e8fdc9f04926006eb7,safer,2,0,2
513d7a55fdc9f035870067c5,5141397afdc9f04926005498,safer,0,2,2
513d7a5bfdc9f035870067db,51414d72fdc9f049260075bb,more depressing,0,2,2
513d7a6dfdc9f03587006818,513e1dddfdc9f03587009aee,safer,2,0,2
513d7a83fdc9f0358700686b,51413b2ffdc9f049260058ca,more boring,0,2,2
513d79ecfdc9f0358700665f,5185d2b6fdc9f03fd500121b,livelier,2,0,2
513d79f8fdc9f03587006687,514147b8fdc9f04926006b03,safer,0,2,2
513d79fdfdc9f0358700669f,513d7d21fdc9f03587007101,livelier,0,2,2
513d7a10fdc9f035870066e0,513d7c3efdc9f03587006e24,more depressing,2,0,2
513d7a12fdc9f035870066e6,513d9fcefdc9f03587008816,more boring,2,0,2
513d7a13fdc9f035870066e9,51408fcefdc9f0492600017d,safer,2,0,2
513d7a37fdc9f0358700675e,51415042fdc9f04926007cd4,livelier,2,0,2
513d7a3efdc9f03587006770,513e2022fdc9f0358700a108,wealthier,2,0,2
513d7b10fdc9f03587006a36,5140cc8cfdc9f04926002e1b,more depressing,2,0,2
50f5eb1efdc9f065f0007fe6,513e2004fdc9f0358700a0b7,livelier,2,0,2
50f5eb1ffdc9f065f0007ff1,5141448cfdc9f049260064fc,livelier,2,0,2
50f5eb20fdc9f065f0007ffd,513e1a77fdc9f035870091fe,livelier,2,0,2
50f5eb20fdc9f065f0008007,513d331efdc9f03587002934,safer,2,0,2
50f5eb21fdc9f065f0008017,513d69c5fdc9f0358700484b,safer,0,2,2
50f5eb23fdc9f065f0008032,51413fdefdc9f04926006023,livelier,2,0,2
513d7aadfdc9f035870068f9,513d7d1bfdc9f035870070ec,wealthier,2,0,2
513d7aaefdc9f035870068fc,5140b92efdc9f04926001dc6,more depressing,0,2,2
513d7acffdc9f03587006968,513d9c50fdc9f03587007cca,more beautiful,2,0,2
513d7ad2fdc9f03587006970,51408fc7fdc9f0492600016d,safer,2,0,2
513d7ad6fdc9f0358700697b,514147d4fdc9f04926006b49,livelier,0,2,2
513d7ad7fdc9f0358700697f,5185cee7fdc9f03fd5000e9b,more beautiful,2,0,2
513d7aedfdc9f035870069be,5140ccb8fdc9f04926002e7a,livelier,2,0,2
50f5eb62fdc9f065f0008235,51408b63fdc9f0358700e908,safer,2,0,2
513d7a8cfdc9f03587006889,51413414fdc9f04926004518,livelier,0,2,2
513d7a90fdc9f0358700689a,5140982dfdc9f04926000c4d,safer,0,2,2
513d7a91fdc9f0358700689c,513f1175fdc9f0358700c835,more boring,2,0,2
513d7aa6fdc9f035870068e9,5140913efdc9f04926000486,livelier,0,2,2
50f5eb44fdc9f065f000814f,513d56f8fdc9f0358700309f,more boring,0,2,2
50f5eb44fdc9f065f0008152,51413acdfdc9f049260057d7,livelier,0,2,2
50f5eb44fdc9f065f0008156,513d6c37fdc9f03587004efa,livelier,0,2,2
50f5eb45fdc9f065f0008166,5185ccfcfdc9f03fd5000cbd,wealthier,2,0,2
50f5eb46fdc9f065f0008176,51413a0efdc9f049260055fc,wealthier,2,0,2
50f5eb47fdc9f065f000818d,5140cc5ffdc9f04926002dac,safer,0,2,2
50f5eb60fdc9f065f000821d,513e6f83fdc9f0358700c5a8,safer,2,0,2
513d7b82fdc9f03587006bbb,51408b4dfdc9f0358700e8dc,safer,2,0,2
513d7b86fdc9f03587006bc5,51415013fdc9f04926007c5e,safer,0,2,2
513d7b90fdc9f03587006be4,51415141fdc9f04926007f40,more depressing,0,2,2
513d7b92fdc9f03587006bec,51422a93fdc9f04926008964,more beautiful,0,2,2
513d7ba0fdc9f03587006c15,513e1fabfdc9f03587009fc3,more beautiful,2,0,2
50f5eaf2fdc9f065f0007e9f,514136f1fdc9f04926004d39,more depressing,2,0,2
50f5eaf2fdc9f065f0007eaa,5185ccb6fdc9f03fd5000c70,safer,0,2,2
50f5eaf3fdc9f065f0007ec1,513f28dbfdc9f0358700d27a,more beautiful,2,0,2
513d7b62fdc9f03587006b4e,51408bcffdc9f0358700e9e4,safer,0,2,2
513d7b6dfdc9f03587006b6f,513f2b63fdc9f0358700d6ba,more beautiful,2,0,2
513d7b71fdc9f03587006b7a,513d7c06fdc9f03587006d6c,livelier,0,2,2
513d7b72fdc9f03587006b80,513e1f75fdc9f03587009f2a,livelier,2,0,2
513d7b7cfdc9f03587006ba5,513e6b87fdc9f0358700c040,more beautiful,2,0,2
513d7b7ffdc9f03587006baf,51408be1fdc9f0358700ea05,safer,0,2,2
50f5eb3ffdc9f065f00080fe,513da04bfdc9f0358700893e,more depressing,0,2,2
513d7b15fdc9f03587006a48,514135ebfdc9f04926004b87,more beautiful,2,0,2
513d7b17fdc9f03587006a4a,513d7ceafdc9f03587007054,safer,2,0,2
513d7b17fdc9f03587006a4b,514133dafdc9f04926004455,wealthier,0,2,2
513d7b4bfdc9f03587006afc,513d7f6afdc9f035870075e5,safer,0,2,2
513d7b51fdc9f03587006b0f,513d9cc7fdc9f03587007e61,safer,2,0,2
513d7b56fdc9f03587006b21,513d9b08fdc9f035870078a3,livelier,2,0,2
513d7b58fdc9f03587006b2c,513e1b89fdc9f035870094d3,safer,2,0,2
50f5eb23fdc9f065f0008038,513f2c03fdc9f0358700d7d1,safer,0,2,2
50f5eb26fdc9f065f000806e,513d6a44fdc9f035870049f7,more beautiful,0,2,2
50f5eb26fdc9f065f0008075,513d5ddafdc9f0358700397d,safer,2,0,2
50f5eb27fdc9f065f0008079,51413c77fdc9f04926005b2d,more depressing,2,0,2
50f5eb3afdc9f065f00080a1,5140d5d1fdc9f04926003574,more boring,2,0,2
50f5eb3bfdc9f065f00080a8,51414637fdc9f04926006771,livelier,2,0,2
50f5eb3bfdc9f065f00080b2,513d680cfdc9f0358700422f,wealthier,0,2,2
50f5eacdfdc9f065f0007d3e,513d50b6fdc9f03587002eb4,more boring,2,0,2
50f5ead0fdc9f065f0007d70,513f1413fdc9f0358700cbc6,wealthier,0,2,2
50f5ead2fdc9f065f0007d97,513f2b1cfdc9f0358700d649,safer,2,0,2
50f5ead3fdc9f065f0007da6,513d7b67fdc9f03587006b61,safer,0,2,2
50f5ead5fdc9f065f0007dc9,513d69dafdc9f03587004892,wealthier,2,0,2
50f5eae9fdc9f065f0007df8,5140c996fdc9f049260025a1,more depressing,0,2,2
513d7bc5fdc9f03587006c96,514090b9fdc9f04926000369,wealthier,0,2,2
513d7bd9fdc9f03587006cd5,51413a38fdc9f04926005665,wealthier,0,2,2
513d7bf0fdc9f03587006d1f,513d7c02fdc9f03587006d5a,safer,0,2,2
513d7bf7fdc9f03587006d30,51414782fdc9f04926006a83,wealthier,2,0,2
513d7c11fdc9f03587006d8c,513e1e9dfdc9f03587009ced,more boring,2,0,2
513d7c6afdc9f03587006eaf,513f2af7fdc9f0358700d610,safer,2,0,2
513d7c7ffdc9f03587006efc,51409a9efdc9f04926000f80,livelier,2,0,2
50f5eafafdc9f065f0007f43,513d7b67fdc9f03587006b60,more boring,2,0,2
50f5eb17fdc9f065f0007f60,5140da8ffdc9f04926003de6,safer,2,0,2
50f5eb19fdc9f065f0007f80,51422c7ffdc9f04926008b39,more beautiful,0,2,2
50f5eb19fdc9f065f0007f82,513e6a4dfdc9f0358700be98,safer,2,0,2
50f5eaf4fdc9f065f0007ec8,514138edfdc9f04926005333,safer,2,0,2
50f5eaf4fdc9f065f0007ed0,51422a05fdc9f049260088cc,livelier,0,2,2
50f5eaf5fdc9f065f0007eea,5140ca1dfdc9f04926002735,wealthier,0,2,2
50f5eaf6fdc9f065f0007efa,513d9c5ffdc9f03587007d00,wealthier,0,2,2
50f5eaf6fdc9f065f0007efe,513e1cfcfdc9f035870098a6,safer,2,0,2
50f5eaf9fdc9f065f0007f35,5141387dfdc9f04926005222,livelier,0,2,2
50f5eafafdc9f065f0007f42,5185d316fdc9f03fd500126d,safer,2,0,2
50f5eaaefdc9f065f0007c25,51413643fdc9f04926004c1c,livelier,0,2,2
50f5eaaffdc9f065f0007c37,513d5ac3fdc9f0358700342f,safer,2,0,2
50f5eab0fdc9f065f0007c3c,513d7b9afdc9f03587006c04,wealthier,2,0,2
50f5eab1fdc9f065f0007c54,51422a33fdc9f049260088fc,livelier,2,0,2
50f5eac5fdc9f065f0007c8f,513d5709fdc9f035870030c4,wealthier,2,0,2
50f5eac9fdc9f065f0007cda,513e1b2efdc9f035870093d9,safer,2,0,2
50f5eacafdc9f065f0007cf2,51408baffdc9f0358700e9a1,livelier,2,0,2
513d7d03fdc9f035870070a0,5140b7bffdc9f04926001ac1,more beautiful,0,2,2
513d7d0efdc9f035870070c4,513da0b7fdc9f03587008a15,more beautiful,0,2,2
513d7d13fdc9f035870070d4,51414e22fdc9f0492600777d,safer,2,0,2
513d7d1afdc9f035870070e8,513d9f18fdc9f03587008624,more beautiful,0,2,2
513d7d22fdc9f03587007103,5140b6aefdc9f049260017ba,more beautiful,0,2,2
513d7d30fdc9f03587007134,513f2d41fdc9f0358700d9dd,safer,0,2,2
50f5eaacfdc9f065f0007bf9,513cc168fdc9f0358700148a,more boring,0,2,2
513d7c9ffdc9f03587006f62,513e2088fdc9f0358700a222,livelier,2,0,2
513d7cc4fdc9f03587006fd4,51422accfdc9f0492600899b,safer,2,0,2
513d7ccdfdc9f03587006ff6,5141510dfdc9f04926007eca,wealthier,0,2,2
513d7cd6fdc9f03587007017,513e1cf9fdc9f0358700989f,more beautiful,0,2,2
513d7cdafdc9f03587007025,5185d0b3fdc9f03fd5001046,safer,2,0,2
513d7ce1fdc9f03587007037,5140ba06fdc9f04926001f5b,wealthier,0,2,2
513d7cf3fdc9f03587007072,5141341cfdc9f0492600452c,wealthier,0,2,2
513d7cfdfdc9f0358700708f,51414f41fdc9f04926007a53,safer,2,0,2
50f5eaeafdc9f065f0007e06,5140c9cdfdc9f04926002642,more boring,2,0,2
50f5eaebfdc9f065f0007e26,513cc288fdc9f035870015a0,more depressing,0,2,2
50f5eaecfdc9f065f0007e2c,51408a6ffdc9f0358700e711,more boring,2,0,2
50f5eaedfdc9f065f0007e41,51409c58fdc9f049260011a6,safer,2,0,2
50f5eaedfdc9f065f0007e42,513f2e23fdc9f0358700db6b,more boring,0,2,2
513d7c8ffdc9f03587006f32,513e224bfdc9f0358700a534,safer,2,0,2
513d7df0fdc9f035870072d7,514091d5fdc9f049260005bd,more beautiful,0,2,2
513d7df5fdc9f035870072e3,513f2bd5fdc9f0358700d77a,livelier,2,0,2
513d7e26fdc9f03587007342,51409cd7fdc9f0492600123e,more depressing,2,0,2
50f5e8a8fdc9f065f000745d,51409c01fdc9f0492600113c,more beautiful,0,2,2
50f5e8a8fdc9f065f0007466,50f5eee6fdc9f065f000906f,safer,0,2,2
50f5e8a8fdc9f065f0007475,513f2ea9fdc9f0358700dc60,livelier,0,2,2
50f5e8aafdc9f065f0007494,51413880fdc9f04926005228,livelier,0,2,2
50f5eaa6fdc9f065f0007b94,513cc76cfdc9f03587001a3f,safer,0,2,2
50f5eaa7fdc9f065f0007bab,51408fcbfdc9f04926000174,wealthier,2,0,2
513d7d55fdc9f03587007198,513f2dc6fdc9f0358700dad0,wealthier,2,0,2
513d7d70fdc9f035870071ca,513f2e47fdc9f0358700dba6,safer,0,2,2
513d7dbbfdc9f03587007263,5141396bfdc9f0492600547a,more beautiful,2,0,2
513d7dc5fdc9f0358700727c,5140d689fdc9f0492600367d,more beautiful,2,0,2
513d7dd4fdc9f03587007298,513e1b22fdc9f035870093b5,safer,0,2,2
50f5ea5bfdc9f065f0007ab5,513e65b0fdc9f0358700b9d8,wealthier,2,0,2
50f5ea5cfdc9f065f0007ac0,513d5cbbfdc9f03587003786,safer,0,2,2
50f5ea5ffdc9f065f0007afa,5140db28fdc9f04926003e95,livelier,2,0,2
50f5ea61fdc9f065f0007b22,51413aa6fdc9f04926005774,safer,0,2,2
50f5ea61fdc9f065f0007b25,513f2caefdc9f0358700d8ea,safer,0,2,2
50f5ea61fdc9f065f0007b2e,5140cb5efdc9f04926002b2c,wealthier,0,2,2
50f5eaa1fdc9f065f0007b3a,513f31cbfdc9f0358700dff3,livelier,2,0,2
50f5eaa3fdc9f065f0007b5d,513d5d8dfdc9f035870038f7,more beautiful,0,2,2
50f5eacafdc9f065f0007cfe,513cb696fdc9f03587000a59,safer,0,2,2
50f5e8e1fdc9f065f0007587,513f2fadfdc9f0358700de05,more depressing,0,2,2
50f5e8e3fdc9f065f00075a2,513e1a23fdc9f0358700911f,livelier,2,0,2
50f5e8e5fdc9f065f00075db,513d69bbfdc9f0358700482a,more depressing,0,2,2
50f5e8fefdc9f065f00075e3,513da07efdc9f035870089ad,livelier,0,2,2
50f5e8fefdc9f065f00075f3,50f5eb45fdc9f065f0008167,safer,2,0,2
50f5e902fdc9f065f000764b,513d616cfdc9f03587003e3c,more beautiful,2,0,2
513d7f40fdc9f03587007598,51422783fdc9f04926008682,more boring,0,2,2
513d7f54fdc9f035870075b5,513f12abfdc9f0358700c9e2,more depressing,0,2,2
513d7f5cfdc9f035870075c4,51413c9cfdc9f04926005b5c,wealthier,0,2,2
50f5e87efdc9f065f0007334,51414638fdc9f04926006773,livelier,2,0,2
50f5e87efdc9f065f0007341,513f2c08fdc9f0358700d7d7,safer,2,0,2
50f5e895fdc9f065f000738d,513e1ab9fdc9f035870092ac,safer,2,0,2
50f5e896fdc9f065f000739d,513cc1befdc9f035870014dc,more depressing,0,2,2
513d7ee1fdc9f035870074cf,5141479ffdc9f04926006ac4,more beautiful,2,0,2
513d7ef0fdc9f035870074f0,51414ff6fdc9f04926007c13,more depressing,2,0,2
513d7ef6fdc9f035870074fb,5141357bfdc9f04926004a0b,more beautiful,2,0,2
513d7f03fdc9f03587007511,51413998fdc9f049260054de,safer,2,0,2
513d7f09fdc9f0358700751f,514092b6fdc9f049260006e4,livelier,2,0,2
513d7f09fdc9f03587007521,513f2ea5fdc9f0358700dc58,safer,0,2,2
513d7f13fdc9f03587007532,513d9bedfdc9f03587007b84,livelier,2,0,2
513d7f39fdc9f0358700758a,51421abdfdc9f04926008396,more boring,0,2,2
50f5e8cffdc9f065f0007535,513d79e9fdc9f03587006658,more depressing,2,0,2
50f5e8dffdc9f065f0007551,513e2351fdc9f0358700a668,safer,2,0,2
513d7e61fdc9f035870073c2,513f321bfdc9f0358700e03c,more beautiful,2,0,2
513d7e70fdc9f035870073e0,51408926fdc9f0358700e45d,more boring,0,2,2
513d7eb3fdc9f03587007469,5185cb17fdc9f03fd5000ad9,wealthier,2,0,2
513d7ec9fdc9f0358700749e,514150e2fdc9f04926007e65,livelier,2,0,2
513d7edcfdc9f035870074c5,513f3050fdc9f0358700deba,livelier,0,2,2
50f5e8aafdc9f065f00074a3,513e61c3fdc9f0358700b5ca,livelier,0,2,2
50f5e8cafdc9f065f00074d8,513d4c6cfdc9f03587002e2f,wealthier,2,0,2
50f5e8cbfdc9f065f00074e6,50f5ec0ffdc9f065f000866b,more depressing,0,2,2
50f5e8ccfdc9f065f00074fa,51414b43fdc9f04926007072,wealthier,0,2,2
50f5e8ccfdc9f065f0007503,50f60c4dbeb2fed910000286,more depressing,0,2,2
50f5e8cdfdc9f065f0007525,51414cb3fdc9f049260073cf,more beautiful,0,2,2
50f5e8cefdc9f065f0007528,513e6b8bfdc9f0358700c046,safer,0,2,2
513d9ab0fdc9f0358700778a,513d9ed8fdc9f0358700853f,safer,0,2,2
513d9aebfdc9f0358700784c,513e616efdc9f0358700b546,safer,0,2,2
513d9b05fdc9f03587007897,513e5f49fdc9f0358700b202,safer,2,0,2
513d9b08fdc9f035870078a2,514135a8fdc9f04926004ab0,more beautiful,0,2,2
513d9b1efdc9f035870078e9,513e1f6dfdc9f03587009f17,more depressing,0,2,2
50f5e703fdc9f065f0006f42,5185cc77fdc9f03fd5000c33,livelier,2,0,2
50f5e707fdc9f065f0006f9c,513d57acfdc9f035870031d7,safer,2,0,2
50f5e70bfdc9f065f0007012,513f1460fdc9f0358700cc33,more boring,0,2,2
50f5e870fdc9f065f00072ac,50f607d2beb2fed6f800027f,safer,0,2,2
50f5e871fdc9f065f00072c3,513d7d68fdc9f035870071bb,safer,0,2,2
50f5e872fdc9f065f00072d3,513e2007fdc9f0358700a0c0,safer,0,2,2
513d8029fdc9f035870076a0,5140d8a2fdc9f04926003a58,safer,2,0,2
513d9a8ffdc9f0358700770a,513e6148fdc9f0358700b511,more beautiful,2,0,2
513d9aa0fdc9f03587007749,5185d2fffdc9f03fd5001259,livelier,0,2,2
513d9aa9fdc9f03587007769,5185cfeefdc9f03fd5000fa3,livelier,0,2,2
513d9aaefdc9f0358700777e,51422906fdc9f04926008800,more boring,2,0,2
50f5e768fdc9f065f00070f2,513d6e19fdc9f03587005269,safer,0,2,2
50f5e769fdc9f065f0007109,5140d3b4fdc9f04926003413,livelier,2,0,2
50f5e76afdc9f065f0007160,513cc5cafdc9f035870018c0,safer,2,0,2
50f5e76bfdc9f065f000717e,513da039fdc9f0358700890d,safer,0,2,2
50f5e76bfdc9f065f0007188,5140c92bfdc9f04926002466,wealthier,0,2,2
50f5e76bfdc9f065f00071a6,51392c94818ede129600121f,livelier,0,2,2
50f5e86ffdc9f065f000728e,513cbb30fdc9f03587000e9a,more boring,0,2,2
50f5e896fdc9f065f00073ad,5140b99efdc9f04926001ea8,livelier,2,0,2
50f5e897fdc9f065f00073c1,513d5775fdc9f0358700317f,safer,0,2,2
50f5e89afdc9f065f0007402,513f1303fdc9f0358700ca57,livelier,0,2,2
50f5e89bfdc9f065f000740f,513f14d5fdc9f0358700ccdd,safer,0,2,2
50f5e8a7fdc9f065f000744b,5141492bfdc9f04926006d9b,more depressing,2,0,2
50f5e8a7fdc9f065f000744f,513e5e31fdc9f0358700afce,more beautiful,0,2,2
50f5e8a7fdc9f065f0007454,5185cae0fdc9f03fd5000aac,safer,0,2,2
50f5e8a7fdc9f065f000745b,513e5f5ffdc9f0358700b224,safer,0,2,2
50f5e6fbfdc9f065f0006e77,514147a1fdc9f04926006ac8,wealthier,0,2,2
50f5e6fcfdc9f065f0006e80,513e23a9fdc9f0358700a6d2,wealthier,0,2,2
50f5e6fffdc9f065f0006ec7,5140b6fffdc9f04926001896,more depressing,0,2,2
50f5e701fdc9f065f0006f0a,513d7c4ffdc9f03587006e58,safer,2,0,2
50f5e701fdc9f065f0006f0f,513cb584fdc9f0358700094d,livelier,2,0,2
50f5e702fdc9f065f0006f16,50f60b99beb2fed910000128,livelier,0,2,2
50f5e702fdc9f065f0006f20,50f6011fbeb2fed6f800018e,wealthier,2,0,2
513d9bcdfdc9f03587007b15,514150fcfdc9f04926007ea7,safer,0,2,2
513d9bd4fdc9f03587007b29,51414d35fdc9f04926007522,safer,2,0,2
50f5e6c6fdc9f065f0006deb,51413519fdc9f049260048c1,livelier,2,0,2
50f5e6c9fdc9f065f0006e0f,51414571fdc9f049260065ee,livelier,0,2,2
50f5e6cafdc9f065f0006e4a,513d6d8afdc9f03587005182,livelier,2,0,2
513d9b48fdc9f0358700797a,5140901dfdc9f04926000216,wealthier,0,2,2
513d9b78fdc9f03587007a0b,513f2bfffdc9f0358700d7c6,more boring,0,2,2
513d9b8bfdc9f03587007a46,51415115fdc9f04926007edc,more beautiful,0,2,2
513d9badfdc9f03587007ab7,513e1ff9fdc9f0358700a0a0,safer,0,2,2
513d9bc1fdc9f03587007af4,51421ad0fdc9f049260083af,safer,0,2,2
50f5e75bfdc9f065f0007053,51413361fdc9f049260042a5,more depressing,2,0,2
50f5e75bfdc9f065f000705e,513d786bfdc9f0358700616c,safer,2,0,2
50f5e75dfdc9f065f000707e,513f2c15fdc9f0358700d7eb,wealthier,2,0,2
50f5e768fdc9f065f00070d2,51414e6efdc9f0492600784a,safer,0,2,2
513d9b2dfdc9f0358700791a,513f2ad0fdc9f0358700d5d3,wealthier,2,0,2
513d9b35fdc9f03587007931,51422978fdc9f0492600885d,more boring,0,2,2
513d9b45fdc9f03587007970,513e1edbfdc9f03587009d98,livelier,2,0,2
50f5e689fdc9f065f0006cee,50f5e8a5fdc9f065f000741b,more depressing,0,2,2
50f5e689fdc9f065f0006cf7,50f5ee9bfdc9f065f0008f5a,more beautiful,2,0,2
50f5e68ffdc9f065f0006d1a,513f2f4afdc9f0358700dd5c,more beautiful,0,2,2
50f5e690fdc9f065f0006d71,50f5e8cafdc9f065f00074c4,livelier,0,2,2
50f5e690fdc9f065f0006d72,513d7d24fdc9f0358700710d,more boring,0,2,2
513d9c9efdc9f03587007dd9,5140b909fdc9f04926001d7c,livelier,2,0,2
50f5e648fdc9f065f0006c4f,514135ddfdc9f04926004b64,safer,2,0,2
50f5e648fdc9f065f0006c5c,51414841fdc9f04926006c52,more beautiful,0,2,2
50f5e649fdc9f065f0006c7a,513e6c4ffdc9f0358700c152,safer,0,2,2
50f5e685fdc9f065f0006c9d,513d788efdc9f035870061df,livelier,2,0,2
50f5e685fdc9f065f0006ca6,513d9e1ffdc9f035870082de,more boring,2,0,2
50f5e686fdc9f065f0006cb1,513f3298fdc9f0358700e0ab,wealthier,0,2,2
513d9c61fdc9f03587007d07,513e239afdc9f0358700a6c0,safer,0,2,2
513d9c69fdc9f03587007d1f,51422954fdc9f0492600883e,wealthier,0,2,2
513d9c6efdc9f03587007d31,51413dc9fdc9f04926005e00,more depressing,0,2,2
513d9c7bfdc9f03587007d63,514134cffdc9f049260047c1,more beautiful,0,2,2
513d9c7cfdc9f03587007d64,514146c3fdc9f049260068bf,livelier,2,0,2
513d9c99fdc9f03587007dc8,513e5c8dfdc9f0358700ab57,safer,2,0,2
513d9c9cfdc9f03587007dd0,51422919fdc9f04926008811,more beautiful,2,0,2
513d9c9dfdc9f03587007dd8,513e1d77fdc9f035870099eb,safer,0,2,2
50f5e703fdc9f065f0006f33,5140d9e9fdc9f04926003ce5,more beautiful,2,0,2
50f5e703fdc9f065f0006f38,514144e9fdc9f0492600655f,wealthier,2,0,2
513d9c19fdc9f03587007c15,513f3324fdc9f0358700e117,more depressing,0,2,2
513d9c1cfdc9f03587007c20,513e655dfdc9f0358700b964,more beautiful,0,2,2
513d9c40fdc9f03587007c94,514139aafdc9f0492600550a,more depressing,2,0,2
513d9c4efdc9f03587007cc3,5140c894fdc9f04926002297,safer,2,0,2
513d9c50fdc9f03587007cc8,51413509fdc9f04926004894,livelier,2,0,2
513d9d45fdc9f03587007ff8,5140d5c7fdc9f0492600355c,wealthier,2,0,2
513d9d49fdc9f03587008001,51414f2ffdc9f04926007a25,more beautiful,2,0,2
50f5e56cfdc9f065f00068d1,513e1e0ffdc9f03587009b73,more depressing,2,0,2
50f5e56efdc9f065f000690b,513d9decfdc9f03587008233,safer,2,0,2
50f5e583fdc9f065f000693d,513d5ec4fdc9f03587003ae9,more beautiful,2,0,2
513d9cbffdc9f03587007e44,51422e7cfdc9f04926008d1f,safer,0,2,2
513d9cdffdc9f03587007eb5,513e6f18fdc9f0358700c511,wealthier,0,2,2
513d9cebfdc9f03587007edd,513f3255fdc9f0358700e06d,safer,2,0,2
513d9cf1fdc9f03587007ef3,513e5d9dfdc9f0358700ae45,more boring,2,0,2
513d9d0cfdc9f03587007f44,5140b716fdc9f049260018de,safer,0,2,2
513d9d1bfdc9f03587007f74,51413741fdc9f04926004e58,safer,2,0,2
50f5e647fdc9f065f0006c03,513d6e1bfdc9f0358700526c,wealthier,0,2,2
50f5e647fdc9f065f0006c04,51414802fdc9f04926006bb9,wealthier,2,0,2
50f5e647fdc9f065f0006c1b,513d6793fdc9f035870040f0,safer,2,0,2
513d9c9ffdc9f03587007ddf,5140b863fdc9f04926001c30,safer,0,2,2
513d9c9ffdc9f03587007de2,51422bc5fdc9f04926008a86,livelier,0,2,2
513d9ca1fdc9f03587007de7,5140c9b2fdc9f049260025f1,safer,0,2,2
513d9ca1fdc9f03587007dea,51414c85fdc9f0492600735e,more beautiful,0,2,2
513d9cbbfdc9f03587007e35,5140ca15fdc9f04926002716,more boring,2,0,2
50f5e6c6fdc9f065f0006de8,513cc6fafdc9f035870019d7,safer,0,2,2
50f5e5d8fdc9f065f0006ab4,50f5e8cdfdc9f065f0007515,safer,2,0,2
50f5e63afdc9f065f0006b48,51422bbafdc9f04926008a78,safer,2,0,2
50f5e63dfdc9f065f0006b86,513d7984fdc9f03587006516,safer,0,2,2
50f5e640fdc9f065f0006bcd,513d9b69fdc9f035870079d9,safer,0,2,2
50f5e647fdc9f065f0006bed,513d9c99fdc9f03587007dc8,more beautiful,2,0,2
50f5e562fdc9f065f00067d4,51408ba9fdc9f0358700e993,more beautiful,2,0,2
50f5e563fdc9f065f00067ee,513cbe22fdc9f03587001150,livelier,0,2,2
50f5e563fdc9f065f00067ef,513d78aafdc9f03587006240,livelier,2,0,2
50f5e563fdc9f065f00067f6,5141467dfdc9f04926006815,more depressing,0,2,2
50f5e563fdc9f065f0006800,51409ba9fdc9f049260010d4,more beautiful,2,0,2
50f5e564fdc9f065f000680e,513d7ff0fdc9f0358700766f,more depressing,2,0,2
50f5e565fdc9f065f000682d,513d790ffdc9f0358700639e,livelier,2,0,2
50f5e565fdc9f065f000683a,51413632fdc9f04926004c03,wealthier,0,2,2
513d9d7dfdc9f035870080b7,5140dbfefdc9f04926003f6f,safer,0,2,2
513d9d92fdc9f03587008105,5185d18dfdc9f03fd5001109,more beautiful,2,0,2
513d9dc5fdc9f035870081b5,51413490fdc9f049260046d3,livelier,0,2,2
513d9dd7fdc9f035870081ee,51414662fdc9f049260067ce,more boring,0,2,2
50f5e55efdc9f065f000677a,50f5eb67fdc9f065f0008291,livelier,2,0,2
50f5e55ffdc9f065f000679c,5140ca6cfdc9f04926002829,safer,2,0,2
50f5e58ffdc9f065f0006a22,513f2f24fdc9f0358700dd25,livelier,0,2,2
513d9d56fdc9f0358700802d,513e1b04fdc9f03587009363,livelier,2,0,2
513d9d56fdc9f0358700802f,5140d306fdc9f04926003367,livelier,2,0,2
513d9d5ffdc9f0358700804d,513e6272fdc9f0358700b6c8,safer,2,0,2
513d9d63fdc9f0358700805c,5140d253fdc9f049260032c2,more beautiful,2,0,2
513d9d77fdc9f035870080a1,513e5d5ffdc9f0358700ad98,more depressing,2,0,2
513d9d79fdc9f035870080ab,5140d1e3fdc9f04926003254,wealthier,0,2,2
50f5e583fdc9f065f000693d,513f2cb5fdc9f0358700d8fa,more depressing,0,2,2
50f5e585fdc9f065f0006974,513f2e64fdc9f0358700dbda,livelier,2,0,2
50f5e58dfdc9f065f00069c1,514137cffdc9f0492600506d,livelier,2,0,2
50f5e58efdc9f065f00069f1,50f5ee97fdc9f065f0008ef5,more depressing,2,0,2
50f5e58efdc9f065f00069f7,514089dcfdc9f0358700e5e2,more depressing,0,2,2
50f5e58efdc9f065f00069f8,5140ca9efdc9f049260028c0,livelier,0,2,2
50f5e58efdc9f065f0006a0f,513f1339fdc9f0358700caa2,safer,0,2,2
50f56412fdc9f065f00060db,5140b968fdc9f04926001e44,safer,0,2,2
50f5642bfdc9f065f00060de,5141335efdc9f0492600429d,safer,0,2,2
50f5642dfdc9f065f000611f,51413b66fdc9f0492600595b,safer,2,0,2
50f5642efdc9f065f0006126,513e64bbfdc9f0358700b88c,wealthier,2,0,2
50f5642efdc9f065f0006135,5141348efdc9f049260046cd,safer,2,0,2
50f56433fdc9f065f0006191,50f60869beb2fed6f8000426,more depressing,2,0,2
50f56448fdc9f065f00061c6,514147d3fdc9f04926006b46,wealthier,0,2,2
513d9e5dfdc9f035870083aa,5141472efdc9f049260069cc,safer,0,2,2
513d9e5ffdc9f035870083ad,513f11c8fdc9f0358700c8a0,more boring,2,0,2
513d9e62fdc9f035870083ba,51414f3afdc9f04926007a40,more beautiful,0,2,2
513d9e73fdc9f035870083f0,51409025fdc9f0492600022c,safer,0,2,2
513d9e76fdc9f035870083fa,513e6091fdc9f0358700b3f8,livelier,0,2,2
513d9e96fdc9f03587008467,513e1c0bfdc9f03587009625,wealthier,0,2,2
513d9e97fdc9f03587008468,51421acdfdc9f049260083aa,more beautiful,0,2,2
513d9debfdc9f0358700822f,513e6c7ffdc9f0358700c18c,safer,2,0,2
513d9df2fdc9f0358700824b,51409102fdc9f04926000400,more depressing,0,2,2
513d9e0bfdc9f0358700829d,5140ccc8fdc9f04926002e99,livelier,2,0,2
513d9e23fdc9f035870082f1,5140cbe2fdc9f04926002c87,safer,0,2,2
513d9e4bfdc9f03587008375,51408babfdc9f0358700e998,livelier,0,2,2
513d9e4efdc9f0358700837d,513e212dfdc9f0358700a3e2,wealthier,0,2,2
50f5e566fdc9f065f0006848,513f2c7efdc9f0358700d89f,safer,0,2,2
50f5644ffdc9f065f0006274,50f5eab0fdc9f065f0007c3c,more beautiful,0,2,2
50f5e51efdc9f065f000667e,5140b9d1fdc9f04926001f13,livelier,0,2,2
50f5e526fdc9f065f00066b4,513d7d29fdc9f0358700711b,safer,0,2,2
50f5e527fdc9f065f00066ee,51408f9cfdc9f04926000114,more beautiful,0,2,2
50f5e527fdc9f065f00066f2,513d6914fdc9f035870045d7,wealthier,2,0,2
50f5e528fdc9f065f000671e,513f2939fdc9f0358700d316,more depressing,2,0,2
50f563f9fdc9f065f0005f56,513d7dcbfdc9f03587007285,safer,0,2,2
50f563f9fdc9f065f0005f58,513cb650fdc9f03587000a1c,livelier,2,0,2
50f563fbfdc9f065f0005f89,5140da71fdc9f04926003dcb,safer,2,0,2
50f563fcfdc9f065f0005f95,50f5eb60fdc9f065f0008214,livelier,2,0,2
50f563fcfdc9f065f0005fa0,51414fa0fdc9f04926007b3a,wealthier,2,0,2
50f563fcfdc9f065f0005fa7,50f60c47beb2fed9100001fb,more depressing,2,0,2
50f563fffdc9f065f0005fe0,513cbe88fdc9f035870011b7,wealthier,2,0,2
513d9f32fdc9f03587008677,513f3200fdc9f0358700e024,wealthier,2,0,2
513d9f35fdc9f0358700867f,51408c72fdc9f0358700eb1a,more beautiful,0,2,2
513d9f40fdc9f035870086a4,5142283bfdc9f04926008739,more boring,2,0,2
50f563d3fdc9f065f0005eee,514140cefdc9f04926006113,wealthier,2,0,2
50f563d3fdc9f065f0005f03,51413ccafdc9f04926005bc8,more boring,2,0,2
50f563f8fdc9f065f0005f36,513d7bfefdc9f03587006d4f,safer,2,0,2
50f563f8fdc9f065f0005f45,513d6be3fdc9f03587004e20,more beautiful,0,2,2
513d9ec0fdc9f035870084ea,513f12c8fdc9f0358700ca0b,safer,2,0,2
513d9ed3fdc9f03587008529,513f2ffdfdc9f0358700de78,safer,2,0,2
513d9ed3fdc9f0358700852b,5185ce4afdc9f03fd5000e03,more depressing,2,0,2
513d9ed5fdc9f03587008534,5140905bfdc9f0492600029d,safer,0,2,2
513d9f0cfdc9f035870085f5,513e6f6cfdc9f0358700c584,more beautiful,0,2,2
513d9f18fdc9f03587008624,513e6c0ffdc9f0358700c0f6,more beautiful,0,2,2
513d9f1bfdc9f0358700862d,514134b6fdc9f04926004767,safer,0,2,2
513d9f27fdc9f03587008654,513e6ceefdc9f0358700c218,safer,0,2,2
50f56448fdc9f065f00061cb,51413aeefdc9f04926005829,more beautiful,0,2,2
50f56448fdc9f065f00061cb,51413aeefdc9f04926005829,more depressing,2,0,2
50f5644afdc9f065f00061f4,514090fefdc9f049260003f7,more beautiful,2,0,2
50f5644afdc9f065f000620e,514142b9fdc9f04926006312,safer,0,2,2
50f5644ffdc9f065f000626a,51413492fdc9f049260046dd,more beautiful,2,0,2
50f5644ffdc9f065f000626c,513e22a6fdc9f0358700a5a2,wealthier,2,0,2
513d9ea9fdc9f035870084a7,51409344fdc9f04926000772,more boring,0,2,2
513d9eaafdc9f035870084aa,51414cd9fdc9f0492600742f,safer,0,2,2
50f563b6fdc9f065f0005df0,513e6efbfdc9f0358700c4e6,more beautiful,2,0,2
50f563cbfdc9f065f0005e3b,513f3015fdc9f0358700de89,safer,0,2,2
50f563cdfdc9f065f0005e6c,51408f5dfdc9f049260000a4,more beautiful,0,2,2
50f563cffdc9f065f0005ea2,513cc7f4fdc9f03587001ac1,more depressing,2,0,2
50f563d0fdc9f065f0005eab,51413aaafdc9f0492600577e,more beautiful,0,2,2
513da085fdc9f035870089bd,514229f1fdc9f049260088bc,livelier,2,0,2
50f563b1fdc9f065f0005d89,513e6fc0fdc9f0358700c5f6,livelier,2,0,2
50f563b2fdc9f065f0005da4,51409b21fdc9f04926001020,more depressing,2,0,2
50f563b3fdc9f065f0005dac,5140b9f8fdc9f04926001f49,more beautiful,0,2,2
50f563b3fdc9f065f0005db5,50f5ed54fdc9f065f0008c09,safer,0,2,2
50f563b4fdc9f065f0005dd9,513d9ee6fdc9f03587008573,more beautiful,0,2,2
50f563b5fdc9f065f0005de6,5140b86dfdc9f04926001c46,safer,2,0,2
50f563b5fdc9f065f0005ded,51408bc2fdc9f0358700e9c5,livelier,0,2,2
513d9fc7fdc9f03587008804,51414e1afdc9f0492600776b,livelier,0,2,2
513d9fcdfdc9f03587008815,51414da6fdc9f0492600764a,more boring,2,0,2
513da012fdc9f035870088b2,513e5d54fdc9f0358700ad78,safer,2,0,2
513da013fdc9f035870088b6,51413b98fdc9f049260059c5,safer,2,0,2
513da029fdc9f035870088f0,51414806fdc9f04926006bc2,more beautiful,2,0,2
513da02dfdc9f035870088f7,5140cdb9fdc9f04926002f9e,safer,2,0,2
513da059fdc9f0358700895d,513f2f13fdc9f0358700dd05,safer,2,0,2
513da065fdc9f03587008979,5185cea5fdc9f03fd5000e57,wealthier,2,0,2
50f5640bfdc9f065f000601a,513d5779fdc9f03587003185,more beautiful,2,0,2
50f56410fdc9f065f00060a0,513f3014fdc9f0358700de88,wealthier,0,2,2
513d9f49fdc9f035870086bf,514093fcfdc9f0492600082c,safer,2,0,2
513d9f59fdc9f035870086fa,5185d10afdc9f03fd5001089,more depressing,2,0,2
513d9f6cfdc9f03587008733,5185ce51fdc9f03fd5000e0a,livelier,0,2,2
513d9f77fdc9f0358700874b,514227d4fdc9f049260086d3,wealthier,0,2,2
513d9fc3fdc9f035870087fd,5140cce9fdc9f04926002ecf,wealthier,2,0,2
50f56267fdc9f065f00059d8,5140915dfdc9f049260004c8,more depressing,2,0,2
50f56267fdc9f065f00059da,513d5e3afdc9f03587003a29,livelier,2,0,2
50f56267fdc9f065f00059de,5185d308fdc9f03fd5001262,livelier,0,2,2
50f56267fdc9f065f00059e0,5185cd33fdc9f03fd5000cf1,more depressing,2,0,2
50f56267fdc9f065f00059fe,5140d948fdc9f04926003b94,wealthier,0,2,2
50f56269fdc9f065f0005a5f,50f5e6fdfdc9f065f0006e95,more beautiful,2,0,2
50f562d6fdc9f065f0005a97,5140d829fdc9f0492600395f,livelier,0,2,2
50f562d6fdc9f065f0005a9e,513cbe74fdc9f035870011a2,safer,0,2,2
513e1ab0fdc9f03587009296,5140cd26fdc9f04926002f0b,safer,0,2,2
513e1ad3fdc9f035870092ea,5140b6cafdc9f04926001810,safer,2,0,2
513e1adafdc9f035870092fa,513e2028fdc9f0358700a115,more beautiful,0,2,2
513e1af0fdc9f0358700932f,513f2ac8fdc9f0358700d5c4,livelier,0,2,2
513e1b05fdc9f03587009367,5185d01cfdc9f03fd5000fc6,more boring,0,2,2
513e1b15fdc9f03587009390,5185cd9afdc9f03fd5000d5a,more depressing,2,0,2
50f56364fdc9f065f0005d3d,50f61668beb2fed9100007cc,livelier,0,2,2
50f56364fdc9f065f0005d41,513e22ccfdc9f0358700a5d0,livelier,0,2,2
50f56365fdc9f065f0005d57,513d7a7dfdc9f03587006851,more boring,0,2,2
513da0a6fdc9f035870089fa,513e1b27fdc9f035870093c3,livelier,0,2,2
513da0c6fdc9f03587008a2a,513e5dddfdc9f0358700aef8,wealthier,2,0,2
513e1a78fdc9f035870091ff,513e1b49fdc9f03587009429,more boring,0,2,2
513e1a83fdc9f03587009222,5140d852fdc9f049260039b9,wealthier,0,2,2
513e1a8efdc9f0358700923f,5140908bfdc9f04926000307,livelier,2,0,2
50f562e3fdc9f065f0005b44,513d6a4dfdc9f03587004a17,wealthier,0,2,2
50f562e3fdc9f065f0005b60,51414798fdc9f04926006ab7,livelier,0,2,2
50f562e3fdc9f065f0005b65,5140cb9dfdc9f04926002be8,livelier,2,0,2
50f562e3fdc9f065f0005b7c,50f5644cfdc9f065f0006234,more boring,0,2,2
50f5635ffdc9f065f0005cc5,5185d168fdc9f03fd50010e8,livelier,0,2,2
50f56362fdc9f065f0005d12,513cdf13fdc9f0358700210d,safer,2,0,2
50f56363fdc9f065f0005d2b,50f607d3beb2fed6f8000292,safer,0,2,2
50f56258fdc9f065f0005938,513d7dd0fdc9f0358700728d,livelier,2,0,2
50f5625afdc9f065f0005956,51408b37fdc9f0358700e8b1,safer,2,0,2
50f5625afdc9f065f0005963,5140cc11fdc9f04926002cec,more depressing,2,0,2
50f5625bfdc9f065f000597f,513e212ffdc9f0358700a3e8,more depressing,0,2,2
50f5625ffdc9f065f0005981,513d7c81fdc9f03587006f05,wealthier,2,0,2
50f5625ffdc9f065f000599f,513e64abfdc9f0358700b874,safer,2,0,2
50f56260fdc9f065f00059ba,513da0c4fdc9f03587008a26,more beautiful,2,0,2
513e1bb6fdc9f03587009544,513f151cfdc9f0358700cd40,more boring,0,2,2
513e1bbefdc9f0358700955b,51413871fdc9f04926005206,livelier,2,0,2
513e1bc5fdc9f0358700956a,513e1f50fdc9f03587009ec5,more depressing,2,0,2
513e1bcdfdc9f0358700957b,5140d594fdc9f049260034ff,livelier,2,0,2
50f56204fdc9f065f00058ac,513d9cd9fdc9f03587007e9d,wealthier,2,0,2
50f56204fdc9f065f00058ad,514099aefdc9f04926000e49,safer,0,2,2
50f56205fdc9f065f00058e7,5140ca29fdc9f0492600275f,livelier,0,2,2
50f56205fdc9f065f00058f5,50f562ddfdc9f065f0005aed,safer,0,2,2
513e1b3ffdc9f0358700940f,51409041fdc9f04926000264,more beautiful,2,0,2
513e1b47fdc9f03587009425,513e1be3fdc9f035870095be,safer,0,2,2
513e1b59fdc9f03587009455,513e6265fdc9f0358700b6b4,wealthier,2,0,2
513e1b76fdc9f035870094a5,513e62bcfdc9f0358700b738,wealthier,0,2,2
513e1b9dfdc9f03587009501,51413934fdc9f049260053e7,livelier,2,0,2
513e1ba2fdc9f03587009510,513f1522fdc9f0358700cd48,more depressing,0,2,2
513e1bb6fdc9f03587009543,51409a2ffdc9f04926000ef2,safer,0,2,2
50f562d8fdc9f065f0005abe,513e7039fdc9f0358700c69d,safer,0,2,2
50f562d9fdc9f065f0005ac3,513e1bfbfdc9f03587009600,livelier,0,2,2
50f562dafdc9f065f0005ae0,50f563b1fdc9f065f0005d86,livelier,2,0,2
50f562dafdc9f065f0005ae4,50f5ebc6fdc9f065f00084ea,wealthier,2,0,2
50f562dcfdc9f065f0005aeb,5140cde5fdc9f04926002fc3,safer,0,2,2
513e1b1afdc9f035870093a1,513e1c5bfdc9f03587009701,more depressing,0,2,2
513e1b22fdc9f035870093b4,513e65b7fdc9f0358700b9e1,safer,2,0,2
50f561ccfdc9f065f000576b,513f2b96fdc9f0358700d713,livelier,2,0,2
50f561f2fdc9f065f00057a0,513d78c6fdc9f0358700629f,livelier,2,0,2
50f561f3fdc9f065f00057b4,51414cb7fdc9f049260073d9,more depressing,0,2,2
50f561f4fdc9f065f00057cd,5140b640fdc9f04926001678,more boring,2,0,2
50f561fafdc9f065f0005810,5141424bfdc9f049260062a1,safer,0,2,2
50f561fafdc9f065f0005814,513cc33afdc9f03587001649,more beautiful,2,0,2
50f561fbfdc9f065f000582f,513da0b6fdc9f03587008a13,safer,2,0,2
50f561fbfdc9f065f000583f,513e1dbcfdc9f03587009a9a,more boring,2,0,2
513e1c69fdc9f03587009726,5185cdebfdc9f03fd5000dae,wealthier,0,2,2
513e1c6dfdc9f0358700972f,5140c8befdc9f0492600231f,more depressing,0,2,2
50f561cbfdc9f065f0005723,50f5e566fdc9f065f000684d,livelier,0,2,2
50f561ccfdc9f065f0005746,5141360bfdc9f04926004bce,wealthier,2,0,2
50f561ccfdc9f065f0005751,5185c33bfdc9f03fd5000a56,more beautiful,0,2,2
513e1c40fdc9f035870096bb,51414af8fdc9f04926007015,livelier,0,2,2
513e1c42fdc9f035870096c0,51415100fdc9f04926007ead,safer,0,2,2
513e1c57fdc9f035870096f8,5140d8eafdc9f04926003ae5,wealthier,0,2,2
513e1c58fdc9f035870096fb,514217fbfdc9f049260080ba,safer,0,2,2
513e1c60fdc9f03587009714,51413fb9fdc9f04926006000,safer,2,0,2
50f56260fdc9f065f00059c9,514135f7fdc9f04926004ba3,livelier,0,2,2
50f56260fdc9f065f00059ca,51414fa0fdc9f04926007b3a,safer,0,2,2
50f56267fdc9f065f00059d2,5141348cfdc9f049260046c9,wealthier,2,0,2
50f56267fdc9f065f00059d4,514147e6fdc9f04926006b79,safer,0,2,2
513e1c1cfdc9f03587009656,5140d920fdc9f04926003b47,livelier,2,0,2
513e1c27fdc9f03587009679,51409d55fdc9f049260012d5,livelier,0,2,2
513e1c33fdc9f0358700969b,514094abfdc9f049260008ce,safer,2,0,2
513e1d1efdc9f03587009900,51422daffdc9f04926008c58,more depressing,2,0,2
513e1d43fdc9f03587009960,51413a71fdc9f049260056ec,livelier,2,0,2
513e1d4efdc9f0358700997e,51414ee5fdc9f04926007962,more boring,0,2,2
513e1d70fdc9f035870099d7,51421beffdc9f049260084e4,livelier,2,0,2
50f5611cfdc9f065f00053fd,50f56194fdc9f065f000554c,safer,2,0,2
50f5611dfdc9f065f0005411,513d57bafdc9f035870031f7,safer,0,2,2
50f56120fdc9f065f0005441,513d6caffdc9f03587005020,wealthier,2,0,2
50f56121fdc9f065f0005446,51413a6afdc9f049260056d9,more depressing,2,0,2
513e1c93fdc9f03587009798,51414452fdc9f049260064bc,wealthier,2,0,2
513e1cb3fdc9f035870097e2,514098e1fdc9f04926000d37,livelier,2,0,2
513e1cb3fdc9f035870097e2,51413974fdc9f0492600548b,more depressing,2,0,2
513e1cecfdc9f0358700987a,513f2bbafdc9f0358700d756,livelier,2,0,2
50f561bdfdc9f065f0005651,51409acffdc9f04926000fc0,wealthier,0,2,2
50f561c0fdc9f065f0005686,514133a9fdc9f049260043ab,livelier,0,2,2
50f561c1fdc9f065f00056ad,50f563b6fdc9f065f0005e14,more depressing,2,0,2
50f561c4fdc9f065f00056af,513f2899fdc9f0358700d210,more beautiful,0,2,2
50f561c4fdc9f065f00056b3,51409c68fdc9f049260011ba,wealthier,0,2,2
50f561cafdc9f065f00056f5,50f5ebabfdc9f065f0008442,safer,2,0,2
50f561cbfdc9f065f0005705,513d9bcdfdc9f03587007b16,more beautiful,0,2,2
50f56202fdc9f065f000584a,514147a1fdc9f04926006ac9,more boring,2,0,2
50f56203fdc9f065f000586b,51414e37fdc9f049260077af,wealthier,0,2,2
50f56203fdc9f065f0005874,5141408efdc9f049260060d6,livelier,2,0,2
50f56203fdc9f065f0005881,50f5e76afdc9f065f0007171,safer,0,2,2
50f56203fdc9f065f0005884,51413494fdc9f049260046e6,wealthier,2,0,2
50f5619ffdc9f065f00055d6,513d9afdfdc9f0358700787e,safer,0,2,2
50f5619ffdc9f065f0005608,513f29befdc9f0358700d40d,livelier,0,2,2
50f561a0fdc9f065f0005626,50f5eeaafdc9f065f0008f7f,livelier,0,2,2
513e1eb1fdc9f03587009d24,51409c37fdc9f04926001181,wealthier,2,0,2
50f5609bfdc9f065f00052af,51413356fdc9f0492600427b,more boring,0,2,2
50f5609cfdc9f065f00052dd,5185ced8fdc9f03fd5000e8b,more beautiful,2,0,2
50f560f0fdc9f065f0005328,513cc2aefdc9f035870015c3,wealthier,0,2,2
50f560f0fdc9f065f0005333,513e1a6afdc9f035870091db,more boring,2,0,2
50f560f1fdc9f065f000533e,50f5ead1fdc9f065f0007d85,livelier,2,0,2
513e1e06fdc9f03587009b5b,513e220cfdc9f0358700a4f0,safer,2,0,2
513e1e15fdc9f03587009b83,513e5bedfdc9f0358700a9a1,livelier,2,0,2
513e1e23fdc9f03587009ba8,5140917efdc9f0492600050b,more depressing,0,2,2
513e1e25fdc9f03587009baf,513e627bfdc9f0358700b6d5,livelier,0,2,2
513e1e62fdc9f03587009c4f,51413c03fdc9f04926005a9b,livelier,2,0,2
513e1e77fdc9f03587009c8e,5140d8bffdc9f04926003a97,safer,2,0,2
513e1e80fdc9f03587009ca6,513e6432fdc9f0358700b7ca,safer,0,2,2
513e1ea0fdc9f03587009cf7,5140936bfdc9f04926000794,livelier,2,0,2
50f56194fdc9f065f000555b,513d7a49fdc9f03587006796,more depressing,2,0,2
50f56195fdc9f065f000556a,513d6147fdc9f03587003e13,more boring,0,2,2
50f56195fdc9f065f000556f,514138d2fdc9f049260052ef,more boring,2,0,2
513e1d8afdc9f03587009a1d,514091e5fdc9f049260005db,livelier,0,2,2
513e1d96fdc9f03587009a33,5140dafbfdc9f04926003e68,livelier,0,2,2
513e1deffdc9f03587009b1a,51408936fdc9f0358700e485,wealthier,0,2,2
513e1df8fdc9f03587009b38,514145cdfdc9f04926006678,more depressing,0,2,2
513e1df9fdc9f03587009b3a,513e5dadfdc9f0358700ae71,livelier,2,0,2
50f56121fdc9f065f0005448,5140b7e3fdc9f04926001b1c,safer,2,0,2
50f56122fdc9f065f000545d,513d5db8fdc9f03587003945,more depressing,2,0,2
50f56122fdc9f065f0005462,5140d5b2fdc9f04926003533,more beautiful,0,2,2
50f56125fdc9f065f000548e,513e1e54fdc9f03587009c2b,safer,2,0,2
50f5612cfdc9f065f00054b6,513d7aa6fdc9f035870068e9,more boring,2,0,2
50f5612efdc9f065f0005513,513d7e9cfdc9f0358700743c,livelier,2,0,2
50f5612ffdc9f065f0005536,50f5eeb2fdc9f065f000902c,more depressing,2,0,2
50f55eb1fdc9f065f0004e26,50f60872beb2fed6f80004cb,more beautiful,0,2,2
50f56087fdc9f065f000518c,51413861fdc9f049260051e4,livelier,0,2,2
50f5608afdc9f065f00051b7,513929c0818ede129600115d,wealthier,0,2,2
50f5608dfdc9f065f00051de,513d2e92fdc9f035870025b4,wealthier,0,2,2
50f56099fdc9f065f0005251,513d5f18fdc9f03587003b53,safer,2,0,2
50f56099fdc9f065f000525c,513e21d4fdc9f0358700a4ad,more boring,2,0,2
513e1fabfdc9f03587009fc6,5140925afdc9f0492600068e,safer,2,0,2
513e1faffdc9f03587009fd2,51409149fdc9f0492600049c,wealthier,2,0,2
513e1fb2fdc9f03587009fd9,513e6534fdc9f0358700b931,more beautiful,2,0,2
513e1fb5fdc9f03587009fe0,51413402fdc9f049260044da,livelier,0,2,2
50f55eb0fdc9f065f0004e1d,513d357afdc9f03587002ae4,safer,0,2,2
513e1edffdc9f03587009da3,5140ccc4fdc9f04926002e94,more boring,2,0,2
513e1f39fdc9f03587009e85,5185cccafdc9f03fd5000c88,livelier,2,0,2
513e1f3afdc9f03587009e8b,51422e11fdc9f04926008cb0,more depressing,0,2,2
513e1f4bfdc9f03587009eb5,5140998bfdc9f04926000e20,safer,2,0,2
513e1f72fdc9f03587009f24,5141391efdc9f049260053ad,more depressing,2,0,2
513e1f87fdc9f03587009f5b,513f127bfdc9f0358700c99b,wealthier,0,2,2
50f560f4fdc9f065f0005377,513e6e7cfdc9f0358700c43f,more beautiful,0,2,2
50f560fafdc9f065f00053a6,51414309fdc9f04926006363,wealthier,2,0,2
50f560fafdc9f065f00053aa,51413656fdc9f04926004c38,livelier,2,0,2
50f560fafdc9f065f00053b9,51413d71fdc9f04926005d37,wealthier,2,0,2
50f560fafdc9f065f00053c9,5140921bfdc9f04926000648,livelier,2,0,2
50f55e7efdc9f065f0004d21,513d6e33fdc9f0358700528f,safer,0,2,2
50f55e9afdc9f065f0004d81,513e5e0afdc9f0358700af6c,more depressing,2,0,2
50f55e9afdc9f065f0004d85,514137ebfdc9f049260050d8,livelier,2,0,2
50f55e9afdc9f065f0004d86,513d6883fdc9f035870043d2,more beautiful,0,2,2
50f55e9cfdc9f065f0004db1,514134acfdc9f0492600473c,livelier,0,2,2
50f55eaffdc9f065f0004df4,51408bcafdc9f0358700e9d9,safer,2,0,2
50f55e6ffdc9f065f0004c9a,514217eafdc9f049260080a3,safer,2,0,2
50f55e79fdc9f065f0004cb1,513e6efdfdc9f0358700c4e8,safer,2,0,2
50f55e7afdc9f065f0004cc5,50f5e75afdc9f065f0007050,more beautiful,0,2,2
50f55e7afdc9f065f0004cd3,513d6aacfdc9f03587004b19,safer,2,0,2
50f55e7bfdc9f065f0004cda,5140d84afdc9f049260039a8,more beautiful,0,2,2
50f55e7bfdc9f065f0004cdc,51413db1fdc9f04926005dc1,safer,2,0,2
50f55e7dfdc9f065f0004d03,51409b5ffdc9f04926001077,more depressing,2,0,2
513e2036fdc9f0358700a13b,5140cbecfdc9f04926002c9b,safer,0,2,2
513e2040fdc9f0358700a158,513e5e86fdc9f0358700b0c7,wealthier,2,0,2
513e2082fdc9f0358700a211,514150f5fdc9f04926007e92,livelier,0,2,2
513e208bfdc9f0358700a227,5140b7a0fdc9f04926001a63,safer,2,0,2
513e2099fdc9f0358700a249,51408ba4fdc9f0358700e98c,safer,0,2,2
513e209afdc9f0358700a24c,51414bc3fdc9f04926007179,more depressing,0,2,2
50f5609afdc9f065f000526a,50f5eca0fdc9f065f0008ad2,safer,2,0,2
50f5609afdc9f065f000528d,5140b708fdc9f049260018b4,livelier,0,2,2
513e1fe7fdc9f0358700a06b,513f1453fdc9f0358700cc1f,more depressing,2,0,2
513e1ffafdc9f0358700a0a2,51413d12fdc9f04926005c5f,more beautiful,2,0,2
513e2013fdc9f0358700a0e0,51422da0fdc9f04926008c4a,more beautiful,2,0,2
513e2267fdc9f0358700a555,5141514dfdc9f04926007f62,safer,0,2,2
513e2280fdc9f0358700a571,5140d00afdc9f049260031d3,livelier,0,2,2
513e22f5fdc9f0358700a604,51414707fdc9f04926006965,more depressing,2,0,2
50f55e09fdc9f065f0004a02,51421be9fdc9f049260084da,livelier,0,2,2
50f55e0afdc9f065f0004a20,513e7047fdc9f0358700c6b0,safer,2,0,2
50f55e0bfdc9f065f0004a38,513d6d71fdc9f03587005156,safer,0,2,2
50f55e0bfdc9f065f0004a3f,5140ccbbfdc9f04926002e80,safer,0,2,2
513e217efdc9f0358700a44a,51421907fdc9f049260081d3,livelier,2,0,2
513e2198fdc9f0358700a46b,5140d6a5fdc9f0492600369a,more boring,2,0,2
513e21dffdc9f0358700a4bb,514089bdfdc9f0358700e5a7,wealthier,2,0,2
513e21e7fdc9f0358700a4c4,51414d5cfdc9f04926007586,safer,0,2,2
513e21eafdc9f0358700a4c8,513f2b70fdc9f0358700d6cf,wealthier,2,0,2
513e224efdc9f0358700a536,513e22d7fdc9f0358700a5e0,more depressing,2,0,2
513e2256fdc9f0358700a541,513e6fc1fdc9f0358700c5f7,livelier,2,0,2
50f55e6bfdc9f065f0004c43,513f29d6fdc9f0358700d434,livelier,0,2,2
50f55e6cfdc9f065f0004c55,513e5d8dfdc9f0358700ae18,safer,0,2,2
50f55e6cfdc9f065f0004c5e,51421a4ffdc9f04926008322,wealthier,0,2,2
50f55e6dfdc9f065f0004c71,513d9ae4fdc9f03587007834,wealthier,0,2,2
50f55e6efdc9f065f0004c89,513d7b70fdc9f03587006b76,more beautiful,2,0,2
513e2102fdc9f0358700a35f,51422b31fdc9f04926008a05,safer,0,2,2
513e210cfdc9f0358700a37b,5140cc0bfdc9f04926002cdd,more depressing,0,2,2
50f55eaffdc9f065f0004df7,514147eefdc9f04926006b8b,more boring,2,0,2
50f55eb0fdc9f065f0004e06,513d783bfdc9f035870060c8,safer,0,2,2
50f55eb0fdc9f065f0004e0c,513e61d8fdc9f0358700b5eb,livelier,2,0,2
50f55e36fdc9f065f0004b53,5140c9b5fdc9f049260025fa,more boring,0,2,2
50f55e36fdc9f065f0004b61,50f5e5dcfdc9f065f0006af4,safer,2,0,2
50f55e54fdc9f065f0004bf4,51409d19fdc9f0492600128c,livelier,0,2,2
50f55e6afdc9f065f0004c30,514093d4fdc9f04926000804,livelier,0,2,2
50f46498fdc9f065f0004825,513e1b59fdc9f03587009455,livelier,0,2,2
50f46498fdc9f065f0004835,513d9bcafdc9f03587007b0c,more beautiful,0,2,2
50f46498fdc9f065f000483d,50f563b2fdc9f065f0005da2,more beautiful,0,2,2
50f46499fdc9f065f000485c,50f5ebaafdc9f065f0008439,livelier,2,0,2
50f46499fdc9f065f0004864,513d7c01fdc9f03587006d56,livelier,2,0,2
50f46499fdc9f065f000486f,513cb6f6fdc9f03587000ab2,more depressing,2,0,2
50f46499fdc9f065f0004872,513e2008fdc9f0358700a0c3,more depressing,2,0,2
50f4649afdc9f065f0004898,513f2fd3fdc9f0358700de44,safer,0,2,2
513e5cbffdc9f0358700abde,51414cd8fdc9f0492600742a,livelier,2,0,2
513e5cd4fdc9f0358700ac15,514147c1fdc9f04926006b19,more depressing,0,2,2
513e5cdbfdc9f0358700ac26,5140d1f1fdc9f04926003261,livelier,0,2,2
50f46497fdc9f065f00047e6,513f32acfdc9f0358700e0bb,safer,2,0,2
50f46497fdc9f065f00047f1,5142293bfdc9f04926008829,more depressing,2,0,2
50f46497fdc9f065f0004809,50f563b4fdc9f065f0005dcb,more depressing,0,2,2
50f46498fdc9f065f0004823,513e5e5bfdc9f0358700b049,livelier,2,0,2
513e2357fdc9f0358700a672,51413c6afdc9f04926005b1b,wealthier,0,2,2
513e5bbffdc9f0358700a928,513f14a4fdc9f0358700cc94,more boring,2,0,2
513e5bf4fdc9f0358700a9b6,51413a07fdc9f049260055ea,livelier,2,0,2
513e5c3bfdc9f0358700aa7c,5140c9c1fdc9f04926002621,livelier,2,0,2
513e5c50fdc9f0358700aaaf,5140907dfdc9f049260002e8,safer,2,0,2
513e5c50fdc9f0358700aab0,51409c0efdc9f0492600114a,safer,0,2,2
513e5c87fdc9f0358700ab44,513e6a7bfdc9f0358700bed7,safer,2,0,2
513e5c99fdc9f0358700ab7a,514147dffdc9f04926006b64,wealthier,2,0,2
50f55e0cfdc9f065f0004a4f,513cc706fdc9f035870019e5,livelier,0,2,2
50f55e19fdc9f065f0004a92,513e64e6fdc9f0358700b8c7,livelier,0,2,2
50f55e1dfdc9f065f0004ae3,514227bffdc9f049260086bd,safer,2,0,2
50f55e1efdc9f065f0004af5,51413d56fdc9f04926005cfb,livelier,2,0,2
50f55e33fdc9f065f0004b12,50f61675beb2fed9100008bb,more boring,0,2,2
513e2348fdc9f0358700a65b,513f31f8fdc9f0358700e01e,safer,0,2,2
513e5dcbfdc9f0358700aebf,51414dccfdc9f049260076ae,livelier,2,0,2
513e5dddfdc9f0358700aef6,51422ad2fdc9f049260089a2,livelier,2,0,2
513e5de4fdc9f0358700af09,51422aa0fdc9f04926008970,more boring,2,0,2
513e5df4fdc9f0358700af31,51408c0efdc9f0358700ea5f,wealthier,0,2,2
50f4644dfdc9f065f000456a,50f5e5d3fdc9f065f0006a93,more depressing,2,0,2
50f4644dfdc9f065f0004574,513d9a9dfdc9f0358700773f,more depressing,0,2,2
50f46454fdc9f065f000458b,514142eefdc9f04926006347,wealthier,2,0,2
50f4648ffdc9f065f00047c1,51422c6ffdc9f04926008b2a,safer,2,0,2
513e5ce7fdc9f0358700ac48,513f1397fdc9f0358700cb22,more beautiful,0,2,2
513e5d24fdc9f0358700acf4,514098a4fdc9f04926000ceb,more boring,0,2,2
513e5d27fdc9f0358700acfe,51422d65fdc9f04926008c13,more beautiful,0,2,2
513e5d2ffdc9f0358700ad12,513f297ffdc9f0358700d3a1,livelier,0,2,2
513e5d48fdc9f0358700ad56,51413c0dfdc9f04926005aac,more depressing,0,2,2
50f46484fdc9f065f00046b5,50f55e08fdc9f065f00049f2,more boring,0,2,2
50f46485fdc9f065f00046b7,513d6108fdc9f03587003dc5,livelier,0,2,2
50f46485fdc9f065f00046c6,5140ceacfdc9f0492600307f,livelier,0,2,2
50f4648efdc9f065f0004761,50f5e690fdc9f065f0006d5c,wealthier,0,2,2
50f4648efdc9f065f0004775,513e5efbfdc9f0358700b194,safer,2,0,2
50f4648ffdc9f065f0004798,5140cfddfdc9f049260031a4,safer,2,0,2
50f4648ffdc9f065f000479a,514144b4fdc9f04926006522,safer,0,2,2
50f4649afdc9f065f000489a,5185cee4fdc9f03fd5000e96,more depressing,2,0,2
50f4649afdc9f065f00048a8,513f2d13fdc9f0358700d991,wealthier,0,2,2
50f55dd7fdc9f065f00049be,50f5e5d1fdc9f065f0006a77,safer,0,2,2
50f55dd7fdc9f065f00049c1,513d9bb8fdc9f03587007ad9,livelier,2,0,2
50f55dd7fdc9f065f00049c2,50f5eea9fdc9f065f0008f65,livelier,2,0,2
50f46483fdc9f065f0004699,513d6a68fdc9f03587004a62,safer,0,2,2
50f46483fdc9f065f000469c,5140d27afdc9f049260032e5,more beautiful,0,2,2
513e5f3dfdc9f0358700b1ee,514090b1fdc9f04926000358,livelier,0,2,2
513e5f4bfdc9f0358700b205,51409a98fdc9f04926000f79,safer,2,0,2
50f463cafdc9f065f00043c8,513cc2dbfdc9f035870015e9,safer,0,2,2
50f463cafdc9f065f00043e2,51414bdcfdc9f049260071b2,more boring,0,2,2
50f463cbfdc9f065f00043ef,513d30adfdc9f03587002752,more boring,0,2,2
50f4643efdc9f065f0004411,513cb50dfdc9f035870008d2,safer,0,2,2
50f46443fdc9f065f0004481,50f5ea5bfdc9f065f0007ab4,livelier,0,2,2
513e5e52fdc9f0358700b02b,513f2a29fdc9f0358700d4c2,livelier,2,0,2
513e5e70fdc9f0358700b08a,513e6037fdc9f0358700b36e,safer,2,0,2
513e5ea5fdc9f0358700b10b,51413a02fdc9f049260055e0,safer,0,2,2
513e5ec7fdc9f0358700b142,514144a6fdc9f04926006513,safer,2,0,2
513e5eebfdc9f0358700b17c,51414f3ffdc9f04926007a4e,more depressing,2,0,2
513e5eeffdc9f0358700b184,513e6f96fdc9f0358700c5bf,safer,0,2,2
513e5efefdc9f0358700b198,51414716fdc9f0492600698e,safer,0,2,2
513e5f12fdc9f0358700b1b7,5142199efdc9f04926008265,safer,0,2,2
50f46481fdc9f065f0004667,5185d1edfdc9f03fd500115e,more depressing,0,2,2
50f46482fdc9f065f0004681,51413a0efdc9f049260055fc,wealthier,2,0,2
50f46483fdc9f065f000468b,5140c8d5fdc9f04926002362,livelier,0,2,2
513e5df6fdc9f0358700af34,5140cd2efdc9f04926002f15,more beautiful,2,0,2
513e5e13fdc9f0358700af85,5140b716fdc9f049260018de,safer,2,0,2
513e5e17fdc9f0358700af8f,51414785fdc9f04926006a89,livelier,2,0,2
513e5e44fdc9f0358700afff,513f1166fdc9f0358700c823,livelier,2,0,2
513e5e4cfdc9f0358700b019,51408ac9fdc9f0358700e7c8,wealthier,2,0,2
50f46454fdc9f065f000458e,5185d162fdc9f03fd50010e1,more boring,2,0,2
50f46455fdc9f065f00045ab,51414c6dfdc9f04926007323,safer,0,2,2
50f46457fdc9f065f000462e,50f55e56fdc9f065f0004c18,safer,0,2,2
50f46457fdc9f065f0004646,5141392ffdc9f049260053d8,livelier,0,2,2
50f46457fdc9f065f0004651,513e6092fdc9f0358700b3fb,wealthier,2,0,2
50f448b5fdc9f065f0004242,513e6500fdc9f0358700b8ec,more depressing,2,0,2
50f463b4fdc9f065f0004256,513e1b1cfdc9f035870093a3,wealthier,0,2,2
50f463b4fdc9f065f0004267,513e653afdc9f0358700b937,safer,2,0,2
50f463b5fdc9f065f0004270,513e6b55fdc9f0358700bff9,more beautiful,2,0,2
50f463b6fdc9f065f0004282,5140d875fdc9f049260039fb,safer,2,0,2
50f463bbfdc9f065f00042e2,513f1335fdc9f0358700ca9e,livelier,2,0,2
50f463bcfdc9f065f00042f2,513d78aefdc9f0358700624d,safer,2,0,2
513e6035fdc9f0358700b36b,5141374cfdc9f04926004e7f,livelier,2,0,2
513e6053fdc9f0358700b39b,5140c8d7fdc9f0492600236c,more boring,0,2,2
513e60c7fdc9f0358700b44e,514093fafdc9f0492600082a,wealthier,0,2,2
513e6113fdc9f0358700b4c9,513f1447fdc9f0358700cc0d,more depressing,0,2,2
50f448b5fdc9f065f0004230,513e1cc8fdc9f03587009819,more boring,0,2,2
50f448b5fdc9f065f000423c,51408aa2fdc9f0358700e76f,safer,2,0,2
50f4644dfdc9f065f0004541,513d34a6fdc9f03587002a49,livelier,2,0,2
513e5f6ffdc9f0358700b23c,51408c4dfdc9f0358700ead5,livelier,0,2,2
513e5f8efdc9f0358700b26b,51413aeafdc9f0492600581d,safer,2,0,2
513e5f96fdc9f0358700b276,5142283bfdc9f04926008739,safer,0,2,2
513e5fbcfdc9f0358700b2b0,513f2cfffdc9f0358700d971,more beautiful,0,2,2
513e6011fdc9f0358700b332,514139c9fdc9f04926005552,more depressing,2,0,2
50f46444fdc9f065f0004497,513d364afdc9f03587002b81,livelier,0,2,2
50f46444fdc9f065f00044a3,513cc0a6fdc9f035870013cf,more depressing,0,2,2
50f46445fdc9f065f00044b4,513e6007fdc9f0358700b323,safer,2,0,2
50f46445fdc9f065f00044ba,513e5de3fdc9f0358700af04,more beautiful,2,0,2
50f46447fdc9f065f00044c3,5141448cfdc9f049260064fb,more beautiful,0,2,2
50f46447fdc9f065f00044c7,50f5e709fdc9f065f0006fd9,more boring,0,2,2
50f46448fdc9f065f00044e9,50f5e8cdfdc9f065f0007519,livelier,2,0,2
50f46448fdc9f065f00044fc,513d6a92fdc9f03587004acf,more beautiful,2,0,2
50f448aafdc9f065f000414a,51413af9fdc9f04926005841,wealthier,0,2,2
50f448abfdc9f065f000415e,513e6499fdc9f0358700b85a,more beautiful,2,0,2
50f448acfdc9f065f000416a,513d6916fdc9f035870045e1,livelier,0,2,2
50f448acfdc9f065f000416a,513d7d86fdc9f035870071f5,livelier,2,0,2
50f448aefdc9f065f0004192,5185d303fdc9f03fd500125e,wealthier,0,2,2
50f448affdc9f065f00041a5,513e20dafdc9f0358700a2f7,more boring,0,2,2
513e62e2fdc9f0358700b76f,514146a0fdc9f0492600686c,livelier,0,2,2
513e62e5fdc9f0358700b773,5140cd0afdc9f04926002ef1,livelier,0,2,2
513e6445fdc9f0358700b7e3,514137cefdc9f04926005066,safer,2,0,2
513e645afdc9f0358700b804,51408b0dfdc9f0358700e85f,more beautiful,0,2,2
513e648cfdc9f0358700b845,51414d58fdc9f0492600757c,more boring,2,0,2
50f448a9fdc9f065f000412c,513ced99fdc9f035870023d8,wealthier,2,0,2
50f448aafdc9f065f0004136,513d314ffdc9f035870027d3,safer,2,0,2
50f463c9fdc9f065f00043b4,5141381bfdc9f0492600514a,more depressing,0,2,2
513e619bfdc9f0358700b58b,5141338bfdc9f04926004340,livelier,0,2,2
513e6209fdc9f0358700b634,514228cefdc9f049260087c8,safer,2,0,2
513e620efdc9f0358700b63a,5140b78ffdc9f04926001a35,more depressing,2,0,2
513e622ffdc9f0358700b66a,51408c8afdc9f0358700eb4d,livelier,2,0,2
513e6246fdc9f0358700b68c,513e6d2afdc9f0358700c267,safer,2,0,2
513e62a9fdc9f0358700b71a,513f2ff8fdc9f0358700de74,safer,0,2,2
513e62c3fdc9f0358700b741,513f14c6fdc9f0358700ccc5,livelier,0,2,2
50f463c6fdc9f065f0004318,51422b8bfdc9f04926008a54,livelier,0,2,2
50f463c6fdc9f065f0004336,50f5e87cfdc9f065f0007305,more beautiful,2,0,2
50f463c7fdc9f065f000433f,51413505fdc9f04926004883,safer,0,2,2
50f463c7fdc9f065f000436b,513e5bc0fdc9f0358700a92d,wealthier,0,2,2
50f463c8fdc9f065f0004373,51409047fdc9f04926000271,livelier,0,2,2
50f463c8fdc9f065f000438d,50f60b92beb2fed9100000b5,safer,0,2,2
50f463c9fdc9f065f00043b3,5142179afdc9f0492600804b,wealthier,0,2,2
513e6b1ffdc9f0358700bfb5,5140d78afdc9f04926003821,livelier,0,2,2
513e6b4cfdc9f0358700bfef,5140d39cfdc9f049260033fc,safer,2,0,2
513e6b88fdc9f0358700c043,514089e7fdc9f0358700e5fa,livelier,2,0,2
513e6b8dfdc9f0358700c04a,5140d022fdc9f049260031e7,safer,2,0,2
513e6babfdc9f0358700c070,5140d921fdc9f04926003b48,livelier,2,0,2
513e6bb1fdc9f0358700c078,5185d512fdc9f03fd5001471,livelier,0,2,2
513e6bb2fdc9f0358700c07a,514137d1fdc9f04926005076,more boring,2,0,2
513e6546fdc9f0358700b945,513e6b74fdc9f0358700c026,wealthier,2,0,2
513e656dfdc9f0358700b97b,51408a95fdc9f0358700e757,safer,0,2,2
513e65cbfdc9f0358700b9fd,513f2b1efdc9f0358700d64e,safer,2,0,2
513e6a96fdc9f0358700befc,513f2b88fdc9f0358700d6f8,more beautiful,0,2,2
513e6a96fdc9f0358700befd,513e6bd7fdc9f0358700c0a7,more beautiful,2,0,2
513e6aabfdc9f0358700bf1c,5140ca4dfdc9f049260027cb,wealthier,2,0,2
513e6ac3fdc9f0358700bf42,51414c9ffdc9f0492600739b,safer,0,2,2
50f4486afdc9f065f0004099,5140c9cbfdc9f0492600263a,livelier,0,2,2
50f448a3fdc9f065f00040a5,514217cbfdc9f04926008082,more depressing,0,2,2
50f448a4fdc9f065f00040b1,51414e4afdc9f049260077e8,more boring,2,0,2
50f448a5fdc9f065f00040d5,513d9ebafdc9f035870084d9,more boring,2,0,2
50f448a5fdc9f065f00040dd,51408a92fdc9f0358700e752,wealthier,2,0,2
50f448a8fdc9f065f0004119,50f5eeb3fdc9f065f0009045,safer,2,0,2
50f448a8fdc9f065f0004120,513cdb04fdc9f0358700202e,livelier,2,0,2
50f448b0fdc9f065f00041b8,513d9bbdfdc9f03587007ae9,wealthier,0,2,2
50f448b4fdc9f065f00041f5,513f1435fdc9f0358700cbf8,livelier,0,2,2
50f44868fdc9f065f000402f,513e5fa2fdc9f0358700b288,wealthier,0,2,2
50f44868fdc9f065f000404c,514134ecfdc9f04926004829,more beautiful,0,2,2
50f44869fdc9f065f000406d,513d783afdc9f035870060c4,livelier,0,2,2
50f44866fdc9f065f0003fca,513d7d99fdc9f0358700721f,safer,2,0,2
50f44867fdc9f065f0003fea,513da08dfdc9f035870089cd,livelier,2,0,2
50f44867fdc9f065f0003fef,513e1ee9fdc9f03587009dbf,livelier,0,2,2
50f44868fdc9f065f000401a,513d9b69fdc9f035870079d9,livelier,0,2,2
50f44868fdc9f065f000401f,513e1d3bfdc9f03587009948,livelier,2,0,2
50f44812fdc9f065f0003d71,513ceee7fdc9f03587002411,more beautiful,0,2,2
50f4485afdc9f065f0003efa,513e5ecafdc9f0358700b147,safer,0,2,2
50f4485dfdc9f065f0003f16,513d7d78fdc9f035870071d5,wealthier,2,0,2
50f4485efdc9f065f0003f7c,50f4643efdc9f065f000441e,safer,0,2,2
50f44865fdc9f065f0003f8c,513d784cfdc9f03587006100,wealthier,2,0,2
50f44865fdc9f065f0003f92,513d9f21fdc9f03587008644,more beautiful,2,0,2
50f44865fdc9f065f0003f92,514229f1fdc9f049260088bc,safer,2,0,2
50f44866fdc9f065f0003fb7,513e612afdc9f0358700b4e8,livelier,2,0,2
513e6d2dfdc9f0358700c26a,514145d0fdc9f04926006680,safer,2,0,2
513e6d6dfdc9f0358700c2c3,513f3347fdc9f0358700e136,safer,2,0,2
513e6d91fdc9f0358700c2f8,51408ac9fdc9f0358700e7c8,livelier,2,0,2
513e6db6fdc9f0358700c32b,51413540fdc9f04926004948,safer,0,2,2
50f44859fdc9f065f0003ee9,50f5625ffdc9f065f00059a0,more depressing,2,0,2
50f44859fdc9f065f0003ef4,513e2304fdc9f0358700a617,more beautiful,0,2,2
50f4485afdc9f065f0003ef8,50f56432fdc9f065f000618c,more boring,2,0,2
513e6bd8fdc9f0358700c0a8,5140c8ccfdc9f04926002348,livelier,2,0,2
513e6bfbfdc9f0358700c0d5,5141471ffdc9f049260069a5,more depressing,0,2,2
513e6c4afdc9f0358700c14c,5140dacdfdc9f04926003e2e,safer,0,2,2
513e6c83fdc9f0358700c192,5140ce37fdc9f04926003016,more depressing,0,2,2
513e6cecfdc9f0358700c214,513f3224fdc9f0358700e045,wealthier,2,0,2
50f44802fdc9f065f0003c04,513e6dc8fdc9f0358700c345,livelier,2,0,2
50f44803fdc9f065f0003c2e,50f5e690fdc9f065f0006d82,safer,0,2,2
50f44803fdc9f065f0003c36,50f5e704fdc9f065f0006f4e,more boring,0,2,2
50f44806fdc9f065f0003c58,51409862fdc9f04926000c94,more beautiful,2,0,2
50f44807fdc9f065f0003c90,513d37cefdc9f03587002c1a,safer,2,0,2
513f1088fdc9f0358700c6fa,51415074fdc9f04926007d5c,safer,2,0,2
513f10f9fdc9f0358700c795,5141338cfdc9f04926004342,livelier,0,2,2
513f1117fdc9f0358700c7bb,51413a3efdc9f04926005673,more beautiful,0,2,2
50f44800fdc9f065f0003bef,513d30e4fdc9f0358700277c,wealthier,2,0,2
50f44800fdc9f065f0003bff,5185d3b1fdc9f03fd500130f,more beautiful,0,2,2
50f44853fdc9f065f0003e46,513f10f2fdc9f0358700c78e,more beautiful,2,0,2
50f44853fdc9f065f0003e4b,513e65dbfdc9f0358700ba11,more boring,0,2,2
513e6f4efdc9f0358700c55b,51414116fdc9f0492600615d,more depressing,2,0,2
513e6f98fdc9f0358700c5c4,5185d35cfdc9f03fd50012ba,safer,0,2,2
513e6fa8fdc9f0358700c5db,51413853fdc9f049260051c7,wealthier,0,2,2
513e6fadfdc9f0358700c5e2,5185d399fdc9f03fd50012f5,safer,2,0,2
50f44812fdc9f065f0003d82,50f5608efdc9f065f00051fe,wealthier,2,0,2
50f44812fdc9f065f0003d87,513e1c84fdc9f03587009772,livelier,2,0,2
50f44813fdc9f065f0003dc1,5140b6d8fdc9f04926001834,livelier,2,0,2
50f44813fdc9f065f0003dca,5141472bfdc9f049260069c5,wealthier,0,2,2
50f44814fdc9f065f0003de1,5142299efdc9f0492600887b,safer,2,0,2
50f44814fdc9f065f0003dea,513d6893fdc9f03587004407,livelier,2,0,2
50f44852fdc9f065f0003e2b,50f561bdfdc9f065f000564b,more depressing,0,2,2
50f447d3fdc9f065f0003a94,513e5d52fdc9f0358700ad73,livelier,2,0,2
50f447d3fdc9f065f0003ab5,513d7941fdc9f03587006444,livelier,0,2,2
50f447d8fdc9f065f0003ac2,5142282cfdc9f04926008727,more depressing,0,2,2
50f447d8fdc9f065f0003aca,513cb72ffdc9f03587000ae3,more beautiful,2,0,2
50f447d8fdc9f065f0003afd,513f2d09fdc9f0358700d982,livelier,0,2,2
50f447d9fdc9f065f0003b0f,513d7d8efdc9f03587007204,safer,0,2,2
50f447d9fdc9f065f0003b28,51414ea2fdc9f049260078ce,wealthier,0,2,2
50f447dafdc9f065f0003b44,5141501cfdc9f04926007c75,livelier,2,0,2
513f132dfdc9f0358700ca91,5185d04afdc9f03fd5000feb,livelier,2,0,2
513f134efdc9f0358700cabc,51409ea7fdc9f04926001477,safer,0,2,2
513f1382fdc9f0358700cb03,51408fe6fdc9f049260001b0,more depressing,2,0,2
50f447cffdc9f065f0003a41,513cc98efdc9f03587001c3f,wealthier,0,2,2
50f447d0fdc9f065f0003a4f,513f11f3fdc9f0358700c8db,safer,2,0,2
50f447d0fdc9f065f0003a53,513d56b1fdc9f0358700301f,safer,0,2,2
50f447d2fdc9f065f0003a7e,51409001fdc9f049260001e2,more boring,2,0,2
50f447d3fdc9f065f0003a90,5142178cfdc9f0492600803b,livelier,0,2,2
513f11e6fdc9f0358700c8c9,51414e50fdc9f049260077fa,more beautiful,2,0,2
513f1249fdc9f0358700c951,513f336ffdc9f0358700e155,wealthier,0,2,2
513f1261fdc9f0358700c974,51413a04fdc9f049260055e6,wealthier,0,2,2
513f1265fdc9f0358700c979,513f2fb2fdc9f0358700de0d,livelier,2,0,2
513f12d7fdc9f0358700ca1f,514135fdfdc9f04926004bb3,safer,2,0,2
513f12d7fdc9f0358700ca1f,51422715fdc9f04926008619,safer,2,0,2
513f130ffdc9f0358700ca66,5140d1c5fdc9f0492600323e,more beautiful,0,2,2
50f44807fdc9f065f0003c9f,5140b955fdc9f04926001e1d,more beautiful,2,0,2
50f44808fdc9f065f0003cc2,51414663fdc9f049260067d1,safer,0,2,2
50f44808fdc9f065f0003cc8,51422879fdc9f0492600876d,safer,0,2,2
50f44810fdc9f065f0003d0b,513e1a16fdc9f03587009105,safer,0,2,2
50f44810fdc9f065f0003d26,51414fc0fdc9f04926007b8b,more boring,0,2,2
50f44811fdc9f065f0003d4b,50f46440fdc9f065f000443f,safer,2,0,2
513f11affdc9f0358700c884,514147b7fdc9f04926006b00,more depressing,0,2,2
513f11e0fdc9f0358700c8be,51414319fdc9f04926006373,more beautiful,2,0,2
50f445affdc9f065f00035c9,50f5eaecfdc9f065f0007e2a,wealthier,2,0,2
50f445b0fdc9f065f00035cf,513e5c72fdc9f0358700ab12,safer,0,2,2
50f447ccfdc9f065f00039df,513d7ab8fdc9f0358700691a,more depressing,0,2,2
50f447ccfdc9f065f00039df,513d9c92fdc9f03587007dac,safer,2,0,2
50f447cdfdc9f065f00039f7,50f5e5dffdc9f065f0006b1f,more depressing,2,0,2
50f447cdfdc9f065f00039fb,513e6cdefdc9f0358700c206,livelier,0,2,2
50f447cefdc9f065f0003a0d,50f5e690fdc9f065f0006d81,more beautiful,0,2,2
513f2979fdc9f0358700d390,5140b6b6fdc9f049260017d0,more depressing,0,2,2
50f445a9fdc9f065f000354d,51409366fdc9f0492600078f,safer,2,0,2
50f445a9fdc9f065f0003551,51408a68fdc9f0358700e703,more depressing,0,2,2
50f445abfdc9f065f0003565,513e6c16fdc9f0358700c101,livelier,2,0,2
50f445acfdc9f065f0003586,513e1eb1fdc9f03587009d26,more beautiful,0,2,2
513f13cafdc9f0358700cb60,51408953fdc9f0358700e4c1,livelier,0,2,2
513f142bfdc9f0358700cbea,513f14abfdc9f0358700cc9e,more depressing,0,2,2
513f1453fdc9f0358700cc20,51414877fdc9f04926006cd0,safer,0,2,2
513f14a1fdc9f0358700cc91,5140daadfdc9f04926003e09,wealthier,0,2,2
513f14b4fdc9f0358700ccae,514092c6fdc9f049260006f4,more boring,0,2,2
513f14dcfdc9f0358700cce5,5140d7dafdc9f049260038c3,safer,0,2,2
513f14e0fdc9f0358700cceb,513f2b1dfdc9f0358700d64d,safer,0,2,2
50f447dafdc9f065f0003b55,5185cbadfdc9f03fd5000b6f,livelier,2,0,2
50f447dafdc9f065f0003b58,5140d762fdc9f049260037d0,safer,0,2,2
50f447dafdc9f065f0003b6d,513e6f2ffdc9f0358700c533,livelier,2,0,2
50f447dbfdc9f065f0003b80,513cc0befdc9f035870013e8,more beautiful,0,2,2
50f447fdfdc9f065f0003b9e,513e6046fdc9f0358700b385,safer,2,0,2
513f13aafdc9f0358700cb3b,5140cabefdc9f04926002928,safer,0,2,2
513f13aefdc9f0358700cb42,5141382ffdc9f04926005178,livelier,0,2,2
50f43babfdc9f065f00032df,5140cac2fdc9f04926002930,more beautiful,2,0,2
50f43babfdc9f065f00032ee,514099c6fdc9f04926000e68,safer,0,2,2
50f43bacfdc9f065f00032f8,514226d2fdc9f049260085d8,more boring,2,0,2
50f43bacfdc9f065f0003306,513d57eafdc9f0358700324e,safer,0,2,2
50f43badfdc9f065f0003317,514219e5fdc9f049260082b7,more boring,0,2,2
50f43badfdc9f065f0003318,513f2e2dfdc9f0358700db7d,safer,2,0,2
50f43badfdc9f065f0003320,51413d80fdc9f04926005d5b,safer,0,2,2
50f43baffdc9f065f0003334,513d9c1cfdc9f03587007c1f,livelier,2,0,2
513f2a9dfdc9f0358700d57a,5141348efdc9f049260046cc,more beautiful,0,2,2
513f2b63fdc9f0358700d6ba,51409a63fdc9f04926000f3a,livelier,2,0,2
513f2b78fdc9f0358700d6e1,51413993fdc9f049260054d2,more depressing,0,2,2
513f2b89fdc9f0358700d6fb,513f30a8fdc9f0358700df03,safer,0,2,2
513f2b8bfdc9f0358700d6ff,514093c8fdc9f049260007f9,wealthier,2,0,2
513f2ba9fdc9f0358700d733,5141359ffdc9f04926004a8a,livelier,0,2,2
513f2bb8fdc9f0358700d752,51414e23fdc9f04926007780,more depressing,2,0,2
513f2c8cfdc9f0358700d8b4,5140d84dfdc9f049260039ac,more depressing,2,0,2
50f44562fdc9f065f0003490,50f5640efdc9f065f0006076,more beautiful,2,0,2
50f44568fdc9f065f00034f7,50f55e7bfdc9f065f0004ce7,wealthier,2,0,2
50f44568fdc9f065f00034fe,5140cfa2fdc9f04926003168,safer,2,0,2
513f2a17fdc9f0358700d4a1,51409a11fdc9f04926000ecc,wealthier,0,2,2
513f2a8bfdc9f0358700d55c,51413541fdc9f0492600494c,livelier,2,0,2
50f447cefdc9f065f0003a21,50f562e3fdc9f065f0005b61,more boring,2,0,2
50f447cefdc9f065f0003a2d,513e6535fdc9f0358700b932,safer,2,0,2
50f4450bfdc9f065f000341d,5140cb9dfdc9f04926002be8,more beautiful,0,2,2
50f4450bfdc9f065f0003423,5140997bfdc9f04926000e0d,livelier,0,2,2
50f44560fdc9f065f0003451,513cc296fdc9f035870015aa,wealthier,0,2,2
50f44561fdc9f065f000346b,513d6c3dfdc9f03587004f08,more depressing,2,0,2
50f44562fdc9f065f000348b,5185cb3ffdc9f03fd5000b03,more beautiful,2,0,2
50f43b8bfdc9f065f00031ae,513e5e58fdc9f0358700b03f,wealthier,0,2,2
50f43b90fdc9f065f0003219,513f1136fdc9f0358700c7e2,wealthier,0,2,2
50f43b91fdc9f065f0003229,513f2cfafdc9f0358700d969,more boring,0,2,2
50f43b92fdc9f065f0003239,513cb298fdc9f03587000680,more boring,0,2,2
50f43b92fdc9f065f0003241,50f4450afdc9f065f0003407,more depressing,2,0,2
50f43b93fdc9f065f0003258,513f301cfdc9f0358700de8e,livelier,0,2,2
50f43b93fdc9f065f000325a,5140b963fdc9f04926001e39,more boring,0,2,2
513f2e0bfdc9f0358700db4b,514143fefdc9f04926006469,wealthier,2,0,2
513f2e0dfdc9f0358700db4e,514136defdc9f04926004d01,wealthier,0,2,2
50f43b78fdc9f065f0003177,5140b942fdc9f04926001df2,more beautiful,0,2,2
50f43b78fdc9f065f000317d,513d5f59fdc9f03587003ba5,safer,2,0,2
50f43b8afdc9f065f00031a1,513cbd9afdc9f035870010d2,livelier,0,2,2
50f43b8bfdc9f065f00031a5,50f5eb4bfdc9f065f00081df,livelier,0,2,2
50f43b8bfdc9f065f00031aa,513d5d6cfdc9f035870038bb,more depressing,0,2,2
50f44507fdc9f065f00033ce,50f5eb68fdc9f065f00082b0,safer,2,0,2
513f2d34fdc9f0358700d9c5,51413b2bfdc9f049260058c3,wealthier,2,0,2
513f2d73fdc9f0358700da3f,5140cdb9fdc9f04926002f9e,safer,2,0,2
513f2d78fdc9f0358700da47,51409c23fdc9f04926001165,livelier,2,0,2
513f2d98fdc9f0358700da7b,5140cfe1fdc9f049260031a9,safer,2,0,2
513f2d98fdc9f0358700da7b,5185d0effdc9f03fd5001072,more depressing,0,2,2
513f2dcefdc9f0358700dadc,5141474afdc9f04926006a08,more beautiful,0,2,2
50f44502fdc9f065f0003376,513e5c8afdc9f0358700ab4f,livelier,2,0,2
50f44505fdc9f065f00033a6,513e6ee1fdc9f0358700c4c4,more depressing,0,2,2
50f44505fdc9f065f00033a9,50f607d1beb2fed6f800027d,wealthier,2,0,2
50f44505fdc9f065f00033ac,513e1a8cfdc9f03587009238,more depressing,2,0,2
50f44505fdc9f065f00033b2,5140db7bfdc9f04926003ee5,safer,2,0,2
50f44507fdc9f065f00033c2,513ce545fdc9f0358700223b,safer,0,2,2
50f44507fdc9f065f00033cb,51409d4efdc9f049260012d0,more depressing,0,2,2
50f43b74fdc9f065f00030ff,50f5e648fdc9f065f0006c6b,more boring,2,0,2
50f43b74fdc9f065f000310b,50f448aefdc9f065f0004195,livelier,2,0,2
50f43b77fdc9f065f0003163,5140c896fdc9f0492600229c,safer,0,2,2
50f43b77fdc9f065f0003164,513e6023fdc9f0358700b34e,more depressing,2,0,2
50f43b6ffdc9f065f00030a8,5140b7e2fdc9f04926001b18,wealthier,0,2,2
50f43b6ffdc9f065f00030aa,50f5e760fdc9f065f00070c4,more depressing,2,0,2
50f43b6ffdc9f065f00030b3,513d7e19fdc9f03587007327,livelier,2,0,2
50f43b70fdc9f065f00030b9,5185cc74fdc9f03fd5000c31,safer,0,2,2
50f43b70fdc9f065f00030c2,50f5e701fdc9f065f0006f02,more boring,2,0,2
50f43b70fdc9f065f00030c3,50f5ec3efdc9f065f000888c,safer,0,2,2
50f43b70fdc9f065f00030ca,513e20e3fdc9f0358700a30c,wealthier,2,0,2
50f43b73fdc9f065f00030f7,513d9f4afdc9f035870086c7,wealthier,0,2,2
513f2fc3fdc9f0358700de29,5141352ffdc9f0492600490d,livelier,2,0,2
513f2fe1fdc9f0358700de59,5140b727fdc9f0492600190f,livelier,2,0,2
513f2ff0fdc9f0358700de6c,51422758fdc9f04926008656,more beautiful,0,2,2
513f30c5fdc9f0358700df1e,5140d81cfdc9f0492600394a,more beautiful,0,2,2
513f30f8fdc9f0358700df44,5140cb01fdc9f049260029ff,more beautiful,0,2,2
513f30fdfdc9f0358700df49,51414f4efdc9f04926007a76,more beautiful,0,2,2
513f310afdc9f0358700df53,514135fffdc9f04926004bbb,safer,2,0,2
513f3127fdc9f0358700df6d,5140d9e8fdc9f04926003ce3,more depressing,0,2,2
50f43ba7fdc9f065f00032a7,513cb87afdc9f03587000c12,livelier,0,2,2
50f43baafdc9f065f00032c4,514137cffdc9f0492600506f,safer,2,0,2
513f2e48fdc9f0358700dbaa,5141455ffdc9f049260065d8,wealthier,2,0,2
513f2e87fdc9f0358700dc23,514134dffdc9f049260047fc,safer,0,2,2
513f2ea4fdc9f0358700dc57,514094e4fdc9f04926000908,livelier,2,0,2
513f2f9bfdc9f0358700dde3,51408a2bfdc9f0358700e68b,safer,2,0,2
513f2fc2fdc9f0358700de26,5141419dfdc9f049260061e2,livelier,0,2,2
50f43aaefdc9f065f0002f05,50f562e3fdc9f065f0005b68,safer,0,2,2
50f43ab0fdc9f065f0002f37,513d78aefdc9f0358700624c,more boring,0,2,2
50f43ab0fdc9f065f0002f3c,513d364cfdc9f03587002b83,livelier,2,0,2
50f43ab1fdc9f065f0002f62,51413579fdc9f049260049ff,livelier,2,0,2
51408ab7fdc9f0358700e79f,51414fc4fdc9f04926007b94,livelier,2,0,2
51408b0dfdc9f0358700e860,5140b61efdc9f04926001616,safer,0,2,2
51408a09fdc9f0358700e648,51414694fdc9f04926006851,safer,0,2,2
51408ab2fdc9f0358700e796,5185cea7fdc9f03fd5000e5a,more boring,2,0,2
50f43aa5fdc9f065f0002e6e,513cb8eefdc9f03587000c82,safer,0,2,2
50f43aa6fdc9f065f0002e76,514133dafdc9f04926004454,livelier,0,2,2
50f43aa8fdc9f065f0002e9f,51413a7cfdc9f0492600570b,more beautiful,0,2,2
50f43aaafdc9f065f0002ebc,513e1d93fdc9f03587009a2f,more depressing,2,0,2
50f43aabfdc9f065f0002ee7,513e5d89fdc9f0358700ae0e,safer,0,2,2
50f43aadfdc9f065f0002ef8,513e1a7bfdc9f03587009207,more depressing,2,0,2
513f3394fdc9f0358700e176,5185ce6cfdc9f03fd5000e25,safer,2,0,2
513f33acfdc9f0358700e18c,51422ad1fdc9f049260089a1,more beautiful,0,2,2
51408916fdc9f0358700e437,514094b4fdc9f049260008d6,more boring,0,2,2
5140891cfdc9f0358700e443,5140db44fdc9f04926003eb3,more boring,0,2,2
51408932fdc9f0358700e47c,5140c8adfdc9f049260022e5,wealthier,0,2,2
51408941fdc9f0358700e49d,5140dbe1fdc9f04926003f51,livelier,0,2,2
51408984fdc9f0358700e521,51413a15fdc9f0492600560b,more beautiful,0,2,2
51408a06fdc9f0358700e642,5140cb55fdc9f04926002b12,more boring,2,0,2
50f43b78fdc9f065f0003170,513f2a48fdc9f0358700d4f9,wealthier,2,0,2
513f313bfdc9f0358700df7c,51413addfdc9f049260057ff,safer,2,0,2
513f320afdc9f0358700e02e,51413d56fdc9f04926005cfc,safer,0,2,2
513f328ffdc9f0358700e0a5,5140b7a0fdc9f04926001a63,more boring,2,0,2
513f3314fdc9f0358700e10d,51414617fdc9f04926006727,wealthier,0,2,2
513f3330fdc9f0358700e11e,5140995ffdc9f04926000de6,safer,2,0,2
50f43531fdc9f065f0002c9a,513e2182fdc9f0358700a450,safer,0,2,2
50f43532fdc9f065f0002cae,513e1e66fdc9f03587009c5b,more beautiful,0,2,2
50f43532fdc9f065f0002cb0,513d2ec5fdc9f035870025dc,safer,0,2,2
50f43537fdc9f065f0002d09,50f60e74beb2fed910000674,more beautiful,0,2,2
50f43538fdc9f065f0002d15,50f55e7afdc9f065f0004cd6,more boring,0,2,2
50f4353afdc9f065f0002d37,50f5ecf5fdc9f065f0008bae,safer,0,2,2
50f439f6fdc9f065f0002dce,513f1168fdc9f0358700c826,more beautiful,2,0,2
51408f34fdc9f04926000046,51421b5bfdc9f04926008440,safer,2,0,2
51408f24fdc9f04926000028,5140b87cfdc9f04926001c65,livelier,0,2,2
50f4352cfdc9f065f0002c27,51421a47fdc9f04926008319,more boring,2,0,2
50f4352efdc9f065f0002c51,51408a17fdc9f0358700e664,more depressing,2,0,2
50f4352efdc9f065f0002c58,513e21d3fdc9f0358700a4ab,more boring,0,2,2
50f4352efdc9f065f0002c64,513cdb54fdc9f0358700203b,safer,0,2,2
50f4352ffdc9f065f0002c6a,50f5e5d8fdc9f065f0006ab3,wealthier,0,2,2
50f43531fdc9f065f0002c95,51413789fdc9f04926004f60,livelier,0,2,2
51408c2efdc9f0358700ea97,51414b40fdc9f0492600706d,livelier,2,0,2
51408c4bfdc9f0358700ead1,51414fb5fdc9f04926007b6e,more boring,2,0,2
51408c55fdc9f0358700eae6,51413989fdc9f049260054b9,wealthier,2,0,2
51408ca1fdc9f0358700eb77,51409adbfdc9f04926000fce,livelier,0,2,2
51408f22fdc9f04926000023,51422e62fdc9f04926008d01,livelier,2,0,2
51408f22fdc9f04926000024,5140b648fdc9f0492600168f,more beautiful,2,0,2
51408b59fdc9f0358700e8f6,514133a9fdc9f049260043ac,livelier,0,2,2
51408b78fdc9f0358700e935,51408bfefdc9f0358700ea3c,more beautiful,0,2,2
51408b7dfdc9f0358700e941,5140c9fafdc9f049260026cd,more beautiful,2,0,2
51408b90fdc9f0358700e966,5140d7d9fdc9f049260038c1,more depressing,0,2,2
51408b9cfdc9f0358700e979,5140b9a9fdc9f04926001ec2,more boring,0,2,2
51408ba4fdc9f0358700e98c,51409bd4fdc9f04926001104,safer,0,2,2
51408bd5fdc9f0358700e9f1,514137e3fdc9f049260050bd,more boring,2,0,2
51408c05fdc9f0358700ea4b,514217aafdc9f0492600805e,livelier,0,2,2
50f43526fdc9f065f0002bb8,514138a7fdc9f0492600528b,more beautiful,2,0,2
50f43529fdc9f065f0002bec,513e1e52fdc9f03587009c27,more boring,0,2,2
50f43529fdc9f065f0002bfa,50f44806fdc9f065f0003c58,safer,2,0,2
50f4352afdc9f065f0002c01,50f6167fbeb2fed910000949,more depressing,2,0,2
50f4352afdc9f065f0002c07,51413a87fdc9f04926005727,safer,2,0,2
50f4352bfdc9f065f0002c19,51408c23fdc9f0358700ea86,safer,2,0,2
51409201fdc9f04926000611,5140d863fdc9f049260039d6,livelier,2,0,2
50f43519fdc9f065f0002b08,51414428fdc9f04926006498,more depressing,2,0,2
50f4351afdc9f065f0002b1e,513f2b68fdc9f0358700d6c5,more boring,0,2,2
50f4351afdc9f065f0002b24,513cc8befdc9f03587001b7b,safer,2,0,2
50f4351cfdc9f065f0002b50,51414fa5fdc9f04926007b48,livelier,0,2,2
50f43526fdc9f065f0002bb8,514138a7fdc9f0492600528b,livelier,2,0,2
51409058fdc9f04926000299,51413da2fdc9f04926005da7,safer,0,2,2
5140906dfdc9f049260002c3,514091b5fdc9f04926000578,wealthier,0,2,2
514090edfdc9f049260003d2,51409439fdc9f04926000861,more beautiful,0,2,2
5140919efdc9f04926000548,51414ed1fdc9f04926007936,more boring,0,2,2
514091e1fdc9f049260005d0,5140d225fdc9f04926003294,more depressing,2,0,2
514091e2fdc9f049260005d3,51409830fdc9f04926000c52,safer,2,0,2
51408f63fdc9f049260000ad,51413b47fdc9f04926005906,more beautiful,2,0,2
51408f74fdc9f049260000d0,5140cca2fdc9f04926002e50,safer,2,0,2
51408f7cfdc9f049260000db,5140d2c2fdc9f04926003328,safer,2,0,2
51408f8efdc9f049260000fd,5140cca5fdc9f04926002e56,more beautiful,0,2,2
51408f9ffdc9f0492600011b,5140d923fdc9f04926003b4b,more beautiful,2,0,2
51408fc1fdc9f04926000165,51414831fdc9f04926006c28,more beautiful,0,2,2
51408ffffdc9f049260001dd,51414e1cfdc9f0492600776e,more beautiful,0,2,2
50f4349afdc9f065f0002a36,513d9ecefdc9f0358700851a,more beautiful,0,2,2
50f4349afdc9f065f0002a38,514219bffdc9f0492600828a,safer,2,0,2
50f4349afdc9f065f0002a3d,513d9c89fdc9f03587007d91,safer,2,0,2
50f4349ffdc9f065f0002a91,514146e4fdc9f04926006910,more beautiful,0,2,2
50f434a0fdc9f065f0002aa8,513d31f2fdc9f03587002850,wealthier,0,2,2
50f43514fdc9f065f0002ab8,513d9c29fdc9f03587007c45,livelier,0,2,2
50f43515fdc9f065f0002ac7,514135e7fdc9f04926004b7e,wealthier,2,0,2
514098adfdc9f04926000cf9,5140ca0cfdc9f049260026fc,more depressing,0,2,2
514098e5fdc9f04926000d3e,51422e5dfdc9f04926008cfa,livelier,0,2,2
50f43492fdc9f065f00029b2,513ccba8fdc9f03587001d13,safer,0,2,2
50f43492fdc9f065f00029b5,513d9bbafdc9f03587007adf,more beautiful,2,0,2
50f43493fdc9f065f00029d0,513e23b1fdc9f0358700a6db,livelier,0,2,2
50f43495fdc9f065f00029ef,5140b641fdc9f0492600167b,more beautiful,0,2,2
50f43496fdc9f065f00029f8,50f5eaaffdc9f065f0007c32,wealthier,0,2,2
51409423fdc9f0492600084e,51422df6fdc9f04926008c99,more beautiful,2,0,2
5140945bfdc9f0492600087f,5140b949fdc9f04926001e04,safer,2,0,2
51409482fdc9f049260008a4,51413b2efdc9f049260058c8,safer,0,2,2
51409536fdc9f04926000953,5141436dfdc9f049260063da,wealthier,0,2,2
51409561fdc9f0492600097f,51409adcfdc9f04926000fcf,livelier,2,0,2
51409561fdc9f0492600097f,51414245fdc9f0492600629b,wealthier,0,2,2
51409800fdc9f04926000c12,514138f8fdc9f0492600534e,safer,0,2,2
51409835fdc9f04926000c5a,5140b67cfdc9f04926001725,more beautiful,0,2,2
514092cdfdc9f049260006fd,5140b61bfdc9f04926001610,livelier,2,0,2
514092d2fdc9f04926000703,5140c9dbfdc9f04926002670,more boring,2,0,2
514092d2fdc9f04926000703,51415058fdc9f04926007d0c,livelier,2,0,2
514092e8fdc9f0492600071a,51414cfafdc9f04926007487,wealthier,2,0,2
514093d2fdc9f04926000803,51413948fdc9f0492600541e,more beautiful,0,2,2
514093f7fdc9f04926000827,5140b871fdc9f04926001c51,livelier,0,2,2
5140941cfdc9f04926000845,514134dbfdc9f049260047eb,safer,2,0,2
50f4347efdc9f065f0002897,513d792bfdc9f035870063f8,more depressing,0,2,2
50f43480fdc9f065f00028d4,50f44852fdc9f065f0003e2e,wealthier,2,0,2
50f43480fdc9f065f00028d4,513cc4f4fdc9f035870017fa,safer,0,2,2
50f43488fdc9f065f00028f8,50f44810fdc9f065f0003d16,more beautiful,2,0,2
50f43488fdc9f065f00028fb,513cc194fdc9f035870014b3,more beautiful,0,2,2
50f4348bfdc9f065f000292b,513d7da5fdc9f03587007231,livelier,2,0,2
51409b5efdc9f04926001076,514228effdc9f049260087e8,livelier,0,2,2
50f43477fdc9f065f0002827,513d6c16fdc9f03587004ea2,safer,2,0,2
50f43478fdc9f065f0002839,513cd348fdc9f03587001e8d,livelier,2,0,2
50f43478fdc9f065f000283c,513e1a23fdc9f0358700911f,livelier,2,0,2
50f43478fdc9f065f0002840,51413ba3fdc9f049260059e4,wealthier,0,2,2
50f4347bfdc9f065f0002852,50f560fbfdc9f065f00053e3,safer,2,0,2
50f4347bfdc9f065f0002853,513f3107fdc9f0358700df52,livelier,2,0,2
50f4347cfdc9f065f0002865,513da133fdc9f03587008aae,more beautiful,0,2,2
51409968fdc9f04926000df3,5140c9a7fdc9f049260025ce,safer,0,2,2
51409977fdc9f04926000e07,5185d21efdc9f03fd5001187,more depressing,2,0,2
51409998fdc9f04926000e2f,51421b3ffdc9f04926008428,more depressing,0,2,2
51409a31fdc9f04926000ef6,51422a28fdc9f049260088f1,livelier,2,0,2
51409aaafdc9f04926000f92,5140d01dfdc9f049260031e3,wealthier,0,2,2
51409b2efdc9f04926001032,5140cae5fdc9f049260029aa,safer,2,0,2
51409b48fdc9f04926001059,514136e1fdc9f04926004d0b,more depressing,0,2,2
50f43515fdc9f065f0002ac8,513e6a86fdc9f0358700bee5,safer,0,2,2
50f43515fdc9f065f0002ace,513d9ec4fdc9f035870084f9,safer,2,0,2
50f43516fdc9f065f0002ae8,5185d13ffdc9f03fd50010c4,safer,2,0,2
514098ecfdc9f04926000d47,5141466cfdc9f049260067ef,more boring,2,0,2
514098f5fdc9f04926000d55,5185ce1ffdc9f03fd5000dda,wealthier,2,0,2
51409943fdc9f04926000dc3,514227acfdc9f049260086aa,safer,2,0,2
5140995cfdc9f04926000de4,51413574fdc9f049260049f2,livelier,0,2,2
5140b676fdc9f0492600170f,514134a0fdc9f04926004714,safer,0,2,2
50f42f00fdc9f065f00025b2,513d7d19fdc9f035870070e5,safer,2,0,2
50f42f01fdc9f065f00025d1,513f32d1fdc9f0358700e0d8,safer,0,2,2
50f42f01fdc9f065f00025e7,513d9b83fdc9f03587007a32,wealthier,0,2,2
50f42f01fdc9f065f00025ea,5140b791fdc9f04926001a3e,safer,2,0,2
50f433c2fdc9f065f000262c,514134f1fdc9f04926004837,safer,0,2,2
50f433c2fdc9f065f000262f,513d9f3ffdc9f035870086a0,safer,0,2,2
51409c76fdc9f049260011cf,5185d2c7fdc9f03fd500122b,more beautiful,2,0,2
51409c91fdc9f049260011ea,5140b7a1fdc9f04926001a65,safer,2,0,2
51409c97fdc9f049260011f4,5185ccf2fdc9f03fd5000cb1,safer,2,0,2
51409d75fdc9f049260012fc,5140ca89fdc9f04926002885,safer,0,2,2
51409dd6fdc9f04926001378,5140c9b3fdc9f049260025f3,more beautiful,2,0,2
51409e03fdc9f049260013aa,51421ac1fdc9f0492600839c,safer,2,0,2
51409e34fdc9f049260013e8,5140b952fdc9f04926001e15,safer,0,2,2
51409e3bfdc9f049260013f3,5140b7c6fdc9f04926001ad5,wealthier,0,2,2
50f433d7fdc9f065f0002793,50f5e705fdc9f065f0006f81,more boring,2,0,2
50f433d8fdc9f065f0002797,513e1e96fdc9f03587009cdd,more beautiful,2,0,2
50f43475fdc9f065f0002808,513e5e1afdc9f0358700af94,livelier,0,2,2
51409b98fdc9f049260010c0,5140cc82fdc9f04926002e00,livelier,2,0,2
51409bc0fdc9f049260010f0,51422e3afdc9f04926008cd6,wealthier,0,2,2
51409be4fdc9f04926001116,5140cb88fdc9f04926002bab,more boring,2,0,2
51409c1efdc9f0492600115f,51421ac1fdc9f0492600839d,safer,0,2,2
51409c23fdc9f04926001165,51422c0dfdc9f04926008ac6,safer,0,2,2
50f433d1fdc9f065f0002711,513f2e51fdc9f0358700dbb3,wealthier,2,0,2
50f433d2fdc9f065f000271d,50f5611ffdc9f065f0005420,more beautiful,0,2,2
50f433d2fdc9f065f0002727,513cc7a8fdc9f03587001a7c,more beautiful,0,2,2
50f433d2fdc9f065f0002727,513cc7a8fdc9f03587001a7c,safer,0,2,2
50f433d3fdc9f065f000272e,50f5ea5ffdc9f065f0007b0a,more beautiful,0,2,2
50f433d4fdc9f065f0002748,51422e36fdc9f04926008cd0,more beautiful,0,2,2
50f433d6fdc9f065f000276c,513cc744fdc9f03587001a1d,livelier,2,0,2
50f433d6fdc9f065f0002775,513e6b0afdc9f0358700bf9c,wealthier,0,2,2
50f42efcfdc9f065f00024b0,51409c79fdc9f049260011d3,more depressing,0,2,2
50f42efdfdc9f065f00024d3,513e5d33fdc9f0358700ad1b,livelier,0,2,2
50f42efdfdc9f065f00024de,513d7a4cfdc9f035870067a2,safer,0,2,2
50f42efdfdc9f065f00024e1,513e2078fdc9f0358700a1f6,safer,2,0,2
50f42efdfdc9f065f00024e2,514146defdc9f049260068ff,more boring,2,0,2
50f42efefdc9f065f0002507,50f44815fdc9f065f0003e0c,livelier,2,0,2
5140b757fdc9f04926001997,51413acffdc9f049260057dd,livelier,0,2,2
5140b75afdc9f0492600199e,5141342cfdc9f04926004569,safer,2,0,2
5140b75dfdc9f049260019a6,5140cf01fdc9f049260030d5,more beautiful,2,0,2
5140b786fdc9f04926001a18,5140b955fdc9f04926001e1d,livelier,2,0,2
5140b7a3fdc9f04926001a6e,514227f0fdc9f049260086ed,safer,0,2,2
5140b7c3fdc9f04926001acc,51422db5fdc9f04926008c60,more depressing,0,2,2
5140b7defdc9f04926001b0c,5140d69dfdc9f04926003690,wealthier,2,0,2
50f42efcfdc9f065f00024a1,50f60872beb2fed6f80004e0,more beautiful,0,2,2
5140b6a6fdc9f049260017a9,51413463fdc9f04926004635,safer,2,0,2
5140b6b8fdc9f049260017d5,51422e37fdc9f04926008cd2,more beautiful,2,0,2
5140b6bbfdc9f049260017e4,514146b9fdc9f049260068a8,more beautiful,2,0,2
5140b6d2fdc9f04926001823,514135d2fdc9f04926004b4a,safer,2,0,2
5140b6f3fdc9f0492600187a,5140c9c8fdc9f04926002631,more depressing,2,0,2
5140b70afdc9f049260018ba,514146d4fdc9f049260068e8,safer,2,0,2
5140b71efdc9f049260018f5,514229cbfdc9f049260088a3,livelier,0,2,2
50f433c3fdc9f065f0002643,513e7048fdc9f0358700c6b2,safer,2,0,2
50f433c4fdc9f065f000264d,50f5ec34fdc9f065f00087d2,more depressing,2,0,2
50f433c5fdc9f065f0002665,5140926dfdc9f049260006a3,safer,0,2,2
50f433c5fdc9f065f0002667,513e1ebafdc9f03587009d3a,wealthier,2,0,2
50f433c7fdc9f065f0002694,5140d586fdc9f049260034df,livelier,0,2,2
50f433cdfdc9f065f00026b4,50f43b8cfdc9f065f00031cb,livelier,0,2,2
50f433d0fdc9f065f00026f3,513d31a2fdc9f03587002812,more depressing,0,2,2
50f433d0fdc9f065f00026fd,50f55e6efdc9f065f0004c8b,more boring,0,2,2
50f42ef2fdc9f065f0002430,5185d49dfdc9f03fd5001401,safer,2,0,2
50f42ef2fdc9f065f000245f,513f2af3fdc9f0358700d608,more boring,0,2,2
50f42efcfdc9f065f0002494,513e6069fdc9f0358700b3ba,livelier,0,2,2
50f42efcfdc9f065f0002495,514138a7fdc9f0492600528e,more boring,0,2,2
50f42efcfdc9f065f0002496,5185cacffdc9f03fd5000a9a,safer,2,0,2
50f42de0fdc9f065f00022a7,513cd24efdc9f03587001e5f,more beautiful,2,0,2
50f42eaafdc9f065f00022b7,513d9d19fdc9f03587007f70,safer,0,2,2
5140c863fdc9f04926002208,51414387fdc9f049260063f1,safer,2,0,2
50f42eb2fdc9f065f0002396,51413c7cfdc9f04926005b33,wealthier,0,2,2
50f42eedfdc9f065f00023e4,513d7d13fdc9f035870070d5,livelier,2,0,2
50f42eedfdc9f065f00023e9,514093dffdc9f04926000811,livelier,0,2,2
50f42eeefdc9f065f00023eb,513d56bdfdc9f03587003033,livelier,0,2,2
50f42eeffdc9f065f0002407,513da06bfdc9f0358700898a,safer,0,2,2
5140b85efdc9f04926001c22,5185cb45fdc9f03fd5000b0a,more boring,2,0,2
5140b8b6fdc9f04926001cdc,51414eecfdc9f04926007974,more depressing,2,0,2
5140b8d5fdc9f04926001d1c,51414ec8fdc9f0492600791e,more depressing,0,2,2
5140b95cfdc9f04926001e2d,51413bf1fdc9f04926005a83,livelier,0,2,2
5140c859fdc9f049260021ea,5140c983fdc9f04926002567,safer,2,0,2
5140c85efdc9f049260021fa,51422de5fdc9f04926008c8a,livelier,2,0,2
50f42efefdc9f065f0002533,513d57b5fdc9f035870031eb,more beautiful,0,2,2
50f42efffdc9f065f0002564,50f5e56afdc9f065f00068a8,more boring,0,2,2
50f42efffdc9f065f0002577,513d6b74fdc9f03587004d0f,more boring,2,0,2
50f42f00fdc9f065f000258a,513d5cc0fdc9f0358700378e,livelier,2,0,2
50f42f00fdc9f065f00025a7,513d79cdfdc9f035870065f8,safer,2,0,2
50f42f00fdc9f065f00025b1,513d9d28fdc9f03587007f94,wealthier,2,0,2
5140b83dfdc9f04926001bdd,51414f23fdc9f04926007a07,safer,2,0,2
50f42c7ffdc9f065f0001dbf,50f5e705fdc9f065f0006f7e,livelier,2,0,2
50f42c7ffdc9f065f0001dc4,51413840fdc9f0492600519b,safer,0,2,2
50f42c80fdc9f065f0001dd6,514134c3fdc9f04926004792,livelier,0,2,2
50f42c80fdc9f065f0001df4,513d7e7afdc9f035870073f8,safer,2,0,2
50f42c80fdc9f065f0001e10,513e5da3fdc9f0358700ae57,livelier,2,0,2
50f42c81fdc9f065f0001e2c,51409afffdc9f04926000ff8,livelier,0,2,2
50f42dddfdc9f065f0002217,50f43aa6fdc9f065f0002e79,safer,2,0,2
5140ca18fdc9f04926002721,5140d672fdc9f04926003662,livelier,2,0,2
5140ca53fdc9f049260027d9,5140d9ecfdc9f04926003ceb,safer,0,2,2
5140ca5efdc9f049260027fb,51413b77fdc9f04926005981,safer,2,0,2
5140ca95fdc9f049260028a9,51413b2bfdc9f049260058c3,safer,2,0,2
5140caa8fdc9f049260028e0,51414cd8fdc9f04926007429,livelier,2,0,2
50f42c7ffdc9f065f0001da1,50f448a6fdc9f065f00040ea,safer,0,2,2
50f42c7ffdc9f065f0001da2,50f5e562fdc9f065f00067ce,safer,0,2,2
50f42c7ffdc9f065f0001db0,51415091fdc9f04926007daa,wealthier,0,2,2
5140c8cefdc9f0492600234a,514229d1fdc9f049260088a9,safer,2,0,2
5140c8edfdc9f049260023aa,51414676fdc9f04926006804,wealthier,0,2,2
5140c910fdc9f04926002417,5140dab5fdc9f04926003e13,wealthier,0,2,2
5140c964fdc9f04926002507,5140d9bdfdc9f04926003c82,more beautiful,2,0,2
5140c98efdc9f04926002588,51413ca6fdc9f04926005b77,more boring,0,2,2
5140c98ffdc9f0492600258b,5140cc0ffdc9f04926002ce7,more beautiful,2,0,2
5140c99dfdc9f049260025b6,5140cec4fdc9f04926003098,more depressing,0,2,2
5140c9cefdc9f04926002645,51413419fdc9f04926004525,safer,2,0,2
50f42eacfdc9f065f00022f3,51413426fdc9f0492600454f,wealthier,0,2,2
50f42eacfdc9f065f00022fd,51414693fdc9f0492600684d,livelier,0,2,2
50f42eaefdc9f065f0002321,513d9b6dfdc9f035870079e6,safer,2,0,2
50f42eaefdc9f065f000232a,50f4349cfdc9f065f0002a63,safer,2,0,2
50f42eb2fdc9f065f0002383,513cd1f2fdc9f03587001e4f,livelier,2,0,2
5140c891fdc9f0492600228e,5140d705fdc9f04926003724,wealthier,2,0,2
5140c8bafdc9f04926002312,51422a73fdc9f04926008941,wealthier,0,2,2
50f42c6efdc9f065f0001c4e,513e1b33fdc9f035870093eb,livelier,0,2,2
50f42c71fdc9f065f0001c52,513d7a57fdc9f035870067c9,more depressing,0,2,2
50f42c72fdc9f065f0001c75,513f2f67fdc9f0358700dd92,livelier,0,2,2
50f42c73fdc9f065f0001cb4,50f5eb3afdc9f065f00080a1,more beautiful,0,2,2
50f42c7cfdc9f065f0001d02,51409330fdc9f0492600075a,wealthier,0,2,2
50f42c7dfdc9f065f0001d38,50f60120beb2fed6f80001a1,more depressing,2,0,2
50f42c7efdc9f065f0001d5f,513d7bf6fdc9f03587006d2d,livelier,2,0,2
50f42c53fdc9f065f0001adc,513d9e9bfdc9f03587008474,livelier,0,2,2
5140cd77fdc9f04926002f5c,5141509cfdc9f04926007dc3,more boring,0,2,2
5140cd7ffdc9f04926002f66,51413ca3fdc9f04926005b6e,safer,0,2,2
50f42c6dfdc9f065f0001c18,513d2cbdfdc9f03587002458,more boring,0,2,2
50f42c6dfdc9f065f0001c29,51422d78fdc9f04926008c21,safer,2,0,2
50f42c6efdc9f065f0001c2c,513f14a0fdc9f0358700cc90,more boring,2,0,2
50f42c6efdc9f065f0001c2d,50f5eaeffdc9f065f0007e69,safer,0,2,2
50f42c6efdc9f065f0001c36,513d597bfdc9f03587003393,more depressing,0,2,2
50f42c6efdc9f065f0001c38,51413ab1fdc9f04926005792,safer,0,2,2
5140cb25fdc9f04926002a7a,514137cdfdc9f04926005062,wealthier,2,0,2
5140cb2efdc9f04926002a8d,514139e5fdc9f04926005590,more beautiful,2,0,2
5140cb80fdc9f04926002b94,514146d7fdc9f049260068f0,wealthier,0,2,2
5140cb8cfdc9f04926002bb6,5140cd1ffdc9f04926002f01,safer,0,2,2
5140cc0bfdc9f04926002cdd,51413388fdc9f04926004332,more beautiful,2,0,2
5140cc38fdc9f04926002d49,5185d110fdc9f03fd500108e,more boring,2,0,2
5140ccd0fdc9f04926002eac,51414002fdc9f04926006052,safer,0,2,2
50f42ddefdc9f065f0002229,50f46487fdc9f065f00046fc,livelier,2,0,2
50f42ddefdc9f065f000224b,50f43badfdc9f065f0003317,livelier,2,0,2
50f42ddffdc9f065f000226c,5140daccfdc9f04926003e2d,livelier,0,2,2
50f42de0fdc9f065f000228a,50f44569fdc9f065f0003510,more boring,2,0,2
5140cac6fdc9f0492600293c,5140d9cafdc9f04926003ca5,livelier,2,0,2
5140cad6fdc9f04926002971,5140d681fdc9f04926003677,more depressing,2,0,2
5140cadafdc9f0492600297c,514141f6fdc9f04926006243,safer,0,2,2
5140cae5fdc9f049260029ab,5141384afdc9f049260051b4,more beautiful,0,2,2
50f42c1cfdc9f065f0001939,513d803efdc9f035870076bb,safer,2,0,2
50f42c1dfdc9f065f0001950,513d36f4fdc9f03587002bca,wealthier,2,0,2
50f42c1dfdc9f065f0001964,5140cb44fdc9f04926002ad8,more beautiful,0,2,2
50f42c1dfdc9f065f000196e,513cb2e8fdc9f035870006cd,more boring,0,2,2
50f42c1efdc9f065f0001978,513d2cdffdc9f03587002471,more beautiful,2,0,2
50f42c43fdc9f065f0001987,50f448abfdc9f065f0004159,wealthier,0,2,2
50f42c44fdc9f065f00019a7,51409a84fdc9f04926000f64,safer,0,2,2
5140cfc3fdc9f0492600318c,5140d20cfdc9f0492600327d,more boring,0,2,2
5140d2cdfdc9f0492600332f,514146d3fdc9f049260068e5,livelier,0,2,2
5140d308fdc9f04926003369,5140d510fdc9f0492600341d,wealthier,0,2,2
5140d569fdc9f049260034a5,5185cdd8fdc9f03fd5000d9c,livelier,2,0,2
5140d573fdc9f049260034b8,51414e00fdc9f0492600772c,safer,2,0,2
5140d580fdc9f049260034ce,51421c62fdc9f04926008558,more boring,2,0,2
5140d660fdc9f0492600364c,51413469fdc9f0492600464b,livelier,2,0,2
5140d6a1fdc9f04926003696,51414e25fdc9f04926007784,safer,2,0,2
50f42c67fdc9f065f0001b8e,50f448b5fdc9f065f0004234,safer,2,0,2
50f42c68fdc9f065f0001b9e,513cc7f2fdc9f03587001abd,livelier,2,0,2
50f42c68fdc9f065f0001baf,50f43b91fdc9f065f0003224,more beautiful,2,0,2
50f42c69fdc9f065f0001bc0,513cef6ffdc9f0358700242c,livelier,0,2,2
50f42c6afdc9f065f0001be3,513d9e6afdc9f035870083d5,safer,0,2,2
50f42c6bfdc9f065f0001bfc,50f5625ffdc9f065f0005986,more beautiful,0,2,2
5140cdacfdc9f04926002f90,514136effdc9f04926004d37,wealthier,0,2,2
5140cf2efdc9f04926003105,5185d530fdc9f03fd500148b,more depressing,2,0,2
50f42c53fdc9f065f0001ae4,513d7bf9fdc9f03587006d38,more boring,2,0,2
50f42c53fdc9f065f0001af7,50f56198fdc9f065f00055ab,livelier,2,0,2
50f42c53fdc9f065f0001afb,513d7a52fdc9f035870067be,more beautiful,2,0,2
50f42c53fdc9f065f0001b0f,514134fcfdc9f04926004863,safer,2,0,2
50f42c54fdc9f065f0001b29,513cc65efdc9f03587001942,livelier,2,0,2
50f42c55fdc9f065f0001b66,513d7cedfdc9f0358700705c,more beautiful,2,0,2
50f42c67fdc9f065f0001b78,50f447d3fdc9f065f0003a8f,more beautiful,2,0,2
50f42c67fdc9f065f0001b86,513d7a51fdc9f035870067b9,wealthier,0,2,2
50f42c13fdc9f065f000184a,513d56b6fdc9f03587003026,more depressing,0,2,2
50f42c19fdc9f065f0001875,50f43ba4fdc9f065f0003266,safer,2,0,2
50f42c1afdc9f065f0001884,50f43b71fdc9f065f00030d5,safer,2,0,2
50f42c1afdc9f065f000188a,514090e5fdc9f049260003c5,more beautiful,2,0,2
50f42c1bfdc9f065f0001900,513cc0a6fdc9f035870013cf,livelier,2,0,2
50f42c1bfdc9f065f0001900,513d4d8efdc9f03587002e58,more boring,2,0,2
5140d966fdc9f04926003bd9,51414d2afdc9f04926007501,more depressing,2,0,2
5140d9d2fdc9f04926003cbc,5185cba4fdc9f03fd5000b68,wealthier,0,2,2
5140d9edfdc9f04926003ced,51422b0efdc9f049260089dd,livelier,0,2,2
5140daa5fdc9f04926003dfd,51414e10fdc9f04926007753,more boring,2,0,2
50f42c12fdc9f065f0001835,51408b81fdc9f0358700e94b,livelier,0,2,2
50f42c13fdc9f065f0001846,51409d8efdc9f04926001317,livelier,0,2,2
50f42c4cfdc9f065f0001a6f,513d348afdc9f03587002a36,livelier,2,0,2
5140d7b8fdc9f0492600387d,51414c85fdc9f0492600735e,safer,2,0,2
5140d7c8fdc9f049260038a2,514137e1fdc9f049260050b7,more beautiful,2,0,2
5140d7f5fdc9f04926003902,51421845fdc9f04926008108,safer,0,2,2
5140d879fdc9f04926003a04,51413a26fdc9f04926005637,safer,0,2,2
5140d8c6fdc9f04926003aa7,51413847fdc9f049260051ac,wealthier,0,2,2
5140d931fdc9f04926003b66,5141471ffdc9f049260069a8,wealthier,0,2,2
50f42c44fdc9f065f00019b4,513cd822fdc9f03587001f9c,more boring,2,0,2
50f42c46fdc9f065f00019d9,50f5eb71fdc9f065f000835d,safer,2,0,2
50f42c47fdc9f065f00019f8,51422e41fdc9f04926008ce0,livelier,0,2,2
50f42c47fdc9f065f00019fe,50f5e871fdc9f065f00072c0,safer,2,0,2
50f42c49fdc9f065f0001a27,50f4351afdc9f065f0002b18,more depressing,0,2,2
50f42c49fdc9f065f0001a29,5185d143fdc9f03fd50010c8,wealthier,2,0,2
50f42c49fdc9f065f0001a31,513d7d73fdc9f035870071cd,livelier,2,0,2
50f42c4cfdc9f065f0001a60,50f561cbfdc9f065f00056f8,livelier,2,0,2
514133f5fdc9f049260044b0,51413470fdc9f04926004666,livelier,0,2,2
5141340bfdc9f049260044f7,51413ac3fdc9f049260057c0,safer,2,0,2
51413448fdc9f049260045cb,51414d94fdc9f04926007619,livelier,2,0,2
51413452fdc9f049260045fa,51422df9fdc9f04926008c9c,more depressing,0,2,2
50f42bacfdc9f065f000158a,51415070fdc9f04926007d4f,safer,0,2,2
50f42bacfdc9f065f0001590,51413589fdc9f04926004a41,wealthier,2,0,2
50f42badfdc9f065f000159f,513d7dcffdc9f0358700728c,safer,0,2,2
50f42badfdc9f065f00015a9,513d5db8fdc9f03587003945,more beautiful,0,2,2
5140db22fdc9f04926003e8f,51413826fdc9f0492600515d,wealthier,2,0,2
5140db8afdc9f04926003efd,51414fa1fdc9f04926007b3c,safer,2,0,2
51413309fdc9f0492600417c,514138fbfdc9f04926005356,more boring,0,2,2
5141335dfdc9f0492600429b,5141472dfdc9f049260069ca,safer,0,2,2
51413380fdc9f04926004314,5141448cfdc9f049260064fb,more boring,0,2,2
514133d2fdc9f04926004435,51415029fdc9f04926007c96,livelier,0,2,2
514133d2fdc9f04926004436,514145a2fdc9f04926006629,more depressing,0,2,2
50f42c0cfdc9f065f0001797,50f42c13fdc9f065f000183f,wealthier,0,2,2
50f42c0cfdc9f065f00017a0,50f607e2beb2fed6f80003a2,safer,0,2,2
50f42c0dfdc9f065f00017a8,50f44868fdc9f065f0004043,wealthier,0,2,2
50f42c0dfdc9f065f00017b3,51421bb2fdc9f0492600849d,more beautiful,2,0,2
50f42c12fdc9f065f0001804,5140c964fdc9f04926002506,more beautiful,0,2,2
50f42c1bfdc9f065f0001900,5140c92afdc9f04926002464,more depressing,0,2,2
50f42c1cfdc9f065f000190a,50f56089fdc9f065f00051a4,safer,0,2,2
50f42bbcfdc9f065f0001713,50f60e7dbeb2fed9100006be,wealthier,0,2,2
50f42bbcfdc9f065f000172b,513cc9b4fdc9f03587001c60,safer,2,0,2
50f42c09fdc9f065f0001750,51408af7fdc9f0358700e82f,livelier,0,2,2
50f42c0afdc9f065f0001767,50f445affdc9f065f00035b9,livelier,2,0,2
50f42c0bfdc9f065f000177c,514138c0fdc9f049260052c8,more boring,2,0,2
50f42c0bfdc9f065f0001780,513da10efdc9f03587008a86,safer,2,0,2
51413741fdc9f04926004e58,51422ab4fdc9f04926008983,safer,2,0,2
514137cffdc9f0492600506d,5141468efdc9f04926006840,wealthier,0,2,2
50f42b82fdc9f065f0001474,51408a5cfdc9f0358700e6eb,more boring,0,2,2
50f42b83fdc9f065f000148e,50f463b9fdc9f065f00042b7,safer,2,0,2
50f42b83fdc9f065f0001495,50f55e09fdc9f065f0004a07,more depressing,2,0,2
50f42b88fdc9f065f00014ef,513e22ddfdc9f0358700a5e9,livelier,0,2,2
514135a6fdc9f04926004aa6,51422e39fdc9f04926008cd5,more beautiful,2,0,2
514135adfdc9f04926004ac5,51421b81fdc9f04926008467,wealthier,0,2,2
514135eefdc9f04926004b91,51414ef4fdc9f0492600798f,more boring,0,2,2
51413622fdc9f04926004bed,5185cbf8fdc9f03fd5000bb8,safer,0,2,2
51413631fdc9f04926004c02,514219e5fdc9f049260082b7,wealthier,2,0,2
5141365efdc9f04926004c3f,5141396bfdc9f0492600547a,safer,0,2,2
514136b9fdc9f04926004cbd,51414d6efdc9f049260075b0,safer,2,0,2
514136f3fdc9f04926004d3f,51421a28fdc9f049260082f4,safer,0,2,2
50f42bbafdc9f065f0001697,51409929fdc9f04926000d9e,more depressing,0,2,2
50f42bbbfdc9f065f00016e0,513d6cdafdc9f03587005062,livelier,2,0,2
50f42bbbfdc9f065f00016e8,50f42ddffdc9f065f0002264,safer,0,2,2
51413465fdc9f0492600463f,51414c08fdc9f04926007222,more beautiful,2,0,2
51413491fdc9f049260046d9,5185cc34fdc9f03fd5000bf5,livelier,2,0,2
5141352bfdc9f049260048fe,514228d5fdc9f049260087d0,more boring,2,0,2
51413575fdc9f049260049f6,51413911fdc9f04926005390,more beautiful,2,0,2
5141359bfdc9f04926004a7e,51414430fdc9f0492600649f,more beautiful,2,0,2
50f42baefdc9f065f00015b1,50f5ed94fdc9f065f0008d9c,livelier,2,0,2
50f42baefdc9f065f00015b4,513d2eedfdc9f035870025fc,livelier,2,0,2
50f42bb1fdc9f065f000160d,513e6acbfdc9f0358700bf4b,more beautiful,0,2,2
50f42bb1fdc9f065f000160f,51414c86fdc9f0492600735f,safer,0,2,2
50f42bb5fdc9f065f000166b,50f5e8a9fdc9f065f0007483,more boring,2,0,2
50f42bb5fdc9f065f000167c,50f5eee8fdc9f065f00090a5,safer,2,0,2
5141472dfdc9f049260069cb,51421859fdc9f0492600811f,livelier,0,2,2
514147edfdc9f04926006b89,51414f4cfdc9f04926007a71,wealthier,0,2,2
514147f1fdc9f04926006b93,5185d43efdc9f03fd50013a2,livelier,2,0,2
514148d8fdc9f04926006d43,51414df4fdc9f0492600770c,more beautiful,2,0,2
51414b23fdc9f04926007047,5142276efdc9f0492600866a,wealthier,0,2,2
50e5f7d9d7c3df413b0005a6,50f5ec11fdc9f065f0008697,livelier,2,0,2
50e5f7d9d7c3df413b0005a5,514138b2fdc9f049260052ac,more depressing,2,0,2
50e748e8d7c3df413b001428,513d6b90fdc9f03587004d53,livelier,0,2,2
50f42b50fdc9f065f00012f5,513e6428fdc9f0358700b7bd,more boring,0,2,2
51413d71fdc9f04926005d37,514141a1fdc9f049260061ea,more beautiful,0,2,2
5141400bfdc9f0492600605b,5142180ffdc9f049260080cd,livelier,2,0,2
5141418cfdc9f049260061d4,51414e95fdc9f049260078aa,more depressing,0,2,2
514141eefdc9f0492600623b,5141487afdc9f04926006cd6,more beautiful,0,2,2
5141440cfdc9f04926006477,5185cce1fdc9f03fd5000c9e,safer,0,2,2
50f42b49fdc9f065f000128e,50f5ed55fdc9f065f0008c18,more boring,2,0,2
50f42b49fdc9f065f000128f,5140b984fdc9f04926001e7a,more boring,0,2,2
50f42b4ffdc9f065f00012c1,513929a4818ede1296001158,more beautiful,0,2,2
50f42b4ffdc9f065f00012c1,513929a4818ede1296001158,safer,0,2,2
50f42b50fdc9f065f00012d0,513d7f2dfdc9f03587007571,more beautiful,2,0,2
50f42b50fdc9f065f00012e7,513d7b92fdc9f03587006be9,wealthier,0,2,2
50f42b80fdc9f065f000143b,5141361dfdc9f04926004be5,more beautiful,0,2,2
50f42b80fdc9f065f000144b,513e1cedfdc9f0358700987e,more boring,2,0,2
50f3981dfdc9f065f0000ddc,513d7af3fdc9f035870069d4,safer,0,2,2
50f3981dfdc9f065f0000de2,51408f70fdc9f049260000c6,safer,2,0,2
50f3981efdc9f065f0000de8,513d5ef7fdc9f03587003b2c,more boring,0,2,2
50f3981efdc9f065f0000def,51422ac9fdc9f04926008997,safer,0,2,2
50f3981ffdc9f065f0000dfe,51408aeafdc9f0358700e814,more boring,2,0,2
513cedb5fdc9f035870023dd,514135a6fdc9f04926004aa7,livelier,0,2,2
513cef37fdc9f03587002423,514227dbfdc9f049260086da,more boring,2,0,2
513d2cfffdc9f03587002487,51414913fdc9f04926006d83,livelier,0,2,2
513d2d1efdc9f0358700249d,51414fd6fdc9f04926007bc3,livelier,0,2,2
513d2d30fdc9f035870024ad,513f1142fdc9f0358700c7f2,more beautiful,0,2,2
513d2d70fdc9f035870024de,513e1ac8fdc9f035870092cc,more boring,0,2,2
513d2d9afdc9f035870024fe,513f2aabfdc9f0358700d594,more depressing,2,0,2
513d2f7efdc9f03587002662,51414c58fdc9f049260072f0,safer,0,2,2
513d3014fdc9f035870026db,5140ccd0fdc9f04926002ead,more depressing,0,2,2
513d3049fdc9f03587002705,513d7d9bfdc9f03587007224,livelier,2,0,2
513d3050fdc9f0358700270b,51409be8fdc9f0492600111b,livelier,2,0,2
513d305dfdc9f03587002716,513f2d54fdc9f0358700d9ff,wealthier,0,2,2
513d306cfdc9f03587002720,5140d5a9fdc9f04926003525,livelier,0,2,2
513ced8ffdc9f035870023d7,5141514efdc9f04926007f63,more beautiful,0,2,2
514150f4fdc9f04926007e8d,5185cbc6fdc9f03fd5000b89,safer,0,2,2
51421814fdc9f049260080d4,5185cbccfdc9f03fd5000b8f,wealthier,0,2,2
51421b22fdc9f04926008407,5185cad5fdc9f03fd5000aa2,livelier,0,2,2
51421c7bfdc9f04926008579,51422e63fdc9f04926008d03,wealthier,0,2,2
513d2eeefdc9f035870025fd,51413434fdc9f04926004586,wealthier,2,0,2
513d2f21fdc9f0358700261f,514090ddfdc9f049260003b5,livelier,2,0,2
513d2f2cfdc9f03587002626,51408badfdc9f0358700e99f,more beautiful,2,0,2
51414bf3fdc9f049260071eb,5185d303fdc9f03fd500125e,livelier,0,2,2
51414cd5fdc9f04926007421,5185d111fdc9f03fd5001091,safer,0,2,2
51414db3fdc9f04926007665,5185d393fdc9f03fd50012ee,safer,0,2,2
51414e24fdc9f04926007783,51414f54fdc9f04926007a85,safer,0,2,2
51414e30fdc9f049260077a3,51414e4bfdc9f049260077ea,safer,2,0,2
51414ee0fdc9f0492600795c,51414ff7fdc9f04926007c15,livelier,0,2,2
51415078fdc9f04926007d67,5185cfcefdc9f03fd5000f88,safer,0,2,2
